"Gene","Bile duct cancer","Colorectal cancer","Esophageal cancer","Liver cancer","Pancreatic Cancer","Stomach cancer","total"
"MET",1706,5632,1877,1334,1463,3238,15250
"EGF",193,2131,297,135,653,766,4175
"CA1",227,1702,181,138,859,213,3320
"EGFR",134,1321,182,63,353,316,2369
"ALB",66,1220,85,149,222,332,2074
"AKT1",86,647,107,440,256,250,1786
"CD4",88,756,108,111,221,311,1595
"BCL2",69,503,113,302,124,265,1376
"NODAL",259,260,486,60,48,257,1370
"CTNNB1",25,570,25,191,43,92,946
"AFP",120,50,22,525,47,138,902
"BAX",41,382,64,126,51,172,836
"MLH1",9,738,12,6,15,40,820
"TP53",72,398,83,19,95,116,783
"CDH17",22,262,35,114,64,266,763
"CD44",38,355,28,34,119,164,738
"CDKN2A",52,210,48,101,177,109,697
"BRAF",30,573,9,13,15,23,663
"PEMT",130,153,26,54,170,101,634
"F3",35,338,46,42,65,88,614
"MSH2",7,535,10,6,18,34,610
"CA11",5,316,27,11,185,35,579
"DCC",22,438,13,9,28,44,554
"PTEN",39,204,31,116,44,103,537
"SMAD4",35,166,12,40,203,44,500
"CAT",42,245,44,37,58,70,496
"CA4",0,383,7,15,65,24,494
"DLD",2,417,1,15,10,7,452
"CA2",15,178,22,13,176,37,441
"MUC2",86,157,9,23,52,112,439
"CD34",40,128,60,37,26,140,431
"MAPK8",7,170,15,138,40,56,426
"INS",16,252,16,27,61,46,418
"MTOR",29,117,45,103,57,39,390
"CDH1",12,88,20,6,18,244,388
"VIM",49,97,33,100,52,49,380
"BCL2L1",10,162,12,100,51,44,379
"MSH6",7,325,2,2,12,22,370
"FAS",17,200,10,16,42,59,344
"MYC",15,166,31,14,33,82,341
"IL2",11,160,7,77,26,56,337
"PCNA",33,90,9,101,14,89,336
"ERBB2",22,68,43,4,18,175,330
"CDX2",46,144,10,17,23,86,326
"CRP",19,124,82,18,17,54,314
"TNFSF10",13,137,7,98,33,20,308
"BTC",266,7,2,13,11,6,305
"PIK3CA",23,183,27,17,11,30,291
"CCK",28,87,31,8,70,66,290
"CLC",11,128,27,55,37,32,290
"MMP9",17,83,14,76,33,65,288
"MUC5AC",76,62,6,17,46,78,285
"BIRC5",12,122,10,57,38,39,278
"ZHX2",15,139,6,57,38,15,270
"BRCA1",6,128,15,3,69,41,262
"HLA-A",8,139,18,4,37,50,256
"RUNX3",10,72,8,18,10,131,249
"MGMT",13,139,26,15,6,47,246
"MKI67",22,89,17,57,21,38,244
"CA3",6,161,10,11,46,7,241
"FOXP3",15,86,18,56,23,41,239
"BRCA2",9,65,10,6,125,19,234
"CDKN1A",1,114,9,56,20,28,228
"AGA",16,87,26,18,30,49,226
"KRT20",64,82,5,28,21,25,225
"IL6",13,82,17,58,17,34,221
"POR",33,77,25,16,29,37,217
"ARC",16,84,32,13,26,42,213
"EPCAM",20,95,6,54,20,15,210
"HIF1A",7,77,16,46,32,22,200
"TGFB1",6,76,9,46,32,30,199
"TYMS",2,126,14,11,10,29,192
"TNS1",10,72,11,56,12,27,188
"RAC1",5,88,6,30,30,26,185
"CCS",20,91,17,17,12,17,174
"MMP7",9,101,7,12,15,30,174
"SARNP",8,4,2,154,4,2,174
"IGF2-AS",2,82,5,66,2,14,171
"MDM2",11,51,21,46,17,25,171
"MUC6",44,24,3,10,21,68,170
"RHOA",1,65,6,32,24,42,170
"MTHFR",0,99,24,5,3,38,169
"KRT7",56,36,6,44,17,8,167
"CDKN1B",5,66,7,39,20,29,166
"PTGS2",7,103,6,19,5,26,166
"SDS",5,102,8,4,16,31,166
"GEM",81,25,3,5,39,11,164
"XIAP",0,73,11,43,23,13,163
"ADA",7,63,15,8,28,40,161
"GSTP1",4,70,17,28,3,38,160
"IL1B",9,69,5,36,13,28,160
"PMS2",4,150,1,0,3,2,160
"CYP1A1",15,49,27,41,8,15,155
"NOTCH1",13,35,14,40,31,20,153
"MAPK3",8,62,8,31,14,28,151
"CDK4",8,75,18,2,26,19,148
"MAP2K1",5,66,8,27,24,17,147
"FHIT",11,36,34,22,8,34,145
"SMAD3",2,48,9,39,23,23,144
"GRP",2,75,8,5,23,30,143
"MCL1",14,49,5,46,18,11,143
"NAT2",1,101,6,14,7,14,143
"SRC",5,77,15,5,16,25,143
"KRAS",5,86,0,7,38,6,142
"VDR",1,127,8,2,2,2,142
"CCNE1",2,45,10,45,12,26,140
"MUTYH",1,130,1,0,1,7,140
"CCND1",3,53,25,26,13,18,138
"CCL2",2,84,6,13,14,18,137
"ATM",4,70,11,4,24,20,133
"IGF1R",6,51,8,32,22,12,131
"KRT19",35,16,2,57,12,7,129
"TCF7L2",2,99,7,12,1,6,127
"ZEB1",9,41,12,18,31,16,127
"ERCC1",3,54,26,3,6,34,126
"GSK3B",4,71,7,29,4,11,126
"MCC",13,74,12,8,4,15,126
"RET",7,67,5,15,25,7,126
"SHH",6,24,7,15,45,28,125
"MMP2",8,41,8,31,13,23,124
"DNMT1",4,61,10,2,17,29,123
"ABCB1",7,60,8,8,12,23,118
"MAG",7,36,18,10,15,32,118
"SNAI1",4,47,3,33,16,15,118
"KRT8",21,24,7,51,8,6,117
"CXCR4",3,38,12,11,38,14,116
"LOX",3,40,3,24,30,16,116
"STAT3",3,34,5,32,17,22,113
"GAPDH",1,42,5,33,4,25,110
"MUC4",16,14,3,2,60,13,108
"VEGFA",7,43,5,30,11,11,107
"ADM",4,19,11,35,11,26,106
"IGFBP3",2,59,10,18,3,14,106
"TLR4",4,48,8,11,8,26,105
"ELANE",0,9,3,91,0,1,104
"FGFR2",21,11,9,5,1,54,101
"GPC3",8,3,1,83,2,4,101
"CD80",3,56,12,4,10,13,98
"CYP2E1",0,25,26,24,4,19,98
"PDCD1",8,37,6,13,25,9,98
"LGR5",1,70,4,5,4,13,97
"ABCG2",6,39,12,2,16,21,96
"VIP",2,39,18,3,14,19,95
"ANG",3,41,7,8,13,22,94
"SOX2",5,26,16,10,14,23,94
"GPNMB",7,30,6,14,22,14,93
"PDCD4",2,35,11,20,11,14,93
"DPYD",7,55,5,3,7,15,92
"GCG",4,48,8,1,13,18,92
"SOCS1",2,49,0,33,1,7,92
"OTC",4,33,11,5,19,19,91
"PTK2",2,47,4,19,9,10,91
"S100A4",8,39,8,12,13,11,91
"HNF1A",2,25,3,44,5,10,89
"RASSF1",7,28,5,30,3,16,89
"ERBB3",4,39,4,7,18,16,88
"HDAC1",3,32,5,28,10,10,88
"KLF4",1,49,9,2,14,13,88
"ALDH2",0,19,35,15,2,16,87
"KIT",7,29,14,8,9,20,87
"ITGB1",2,42,4,18,15,5,86
"NANOG",5,24,10,17,20,10,86
"NFE2L2",10,36,7,23,6,4,86
"RHO",1,33,3,5,14,30,86
"CCKBR",1,45,0,2,11,26,85
"MPO",7,31,12,15,7,13,85
"CDK1",1,28,3,28,9,15,84
"NFKBIA",2,37,1,23,12,9,84
"SMAD7",0,37,2,17,15,13,84
"CDH2",8,17,6,21,17,13,82
"TYR",2,42,3,12,12,11,82
"VEGFC",6,30,9,8,3,26,82
"NFKB1",1,38,4,17,9,12,81
"OGG1",9,34,5,14,7,12,81
"SFRP1",8,26,3,14,9,20,80
"EPO",16,20,10,5,17,11,79
"SPP1",5,25,0,31,5,13,79
"ACTB",4,32,2,26,2,12,78
"WNT3A",4,36,4,7,10,17,78
"SIRT1",1,26,3,23,16,8,77
"AXIN2",1,59,3,8,0,5,76
"CD14",2,29,5,15,10,15,76
"IL10",2,30,3,14,6,21,76
"NOV",10,31,4,1,12,18,76
"PLAU",2,36,1,14,7,16,76
"TGFBR2",3,40,1,9,15,7,75
"FOXM1",5,11,5,30,9,14,74
"TERT",1,15,4,27,11,16,74
"CD274",6,17,5,20,15,9,72
"RAN",0,36,6,4,9,17,72
"UGT1A1",1,57,2,3,2,7,72
"GSTM1",1,32,9,11,2,16,71
"TNFRSF10B",2,35,2,18,10,4,71
"CAV1",0,37,1,8,12,12,70
"ALK",16,18,5,1,18,11,69
"MIP",2,45,3,5,5,8,68
"HRAS",4,29,2,16,8,8,67
"POMP",14,9,25,2,8,9,67
"DIABLO",1,39,1,12,4,9,66
"PHIP",0,60,0,1,1,4,66
"POU5F1",0,22,7,11,17,9,66
"SMAD2",1,31,2,14,12,6,66
"BAK1",4,30,2,14,6,9,65
"PDCD5",1,39,1,13,2,9,65
"CD28",4,35,6,4,4,11,64
"FEZF2",4,22,6,12,6,14,64
"MUT",2,39,3,7,6,7,64
"SMUG1",13,9,20,14,4,4,64
"MVD",5,17,4,15,4,18,63
"SST",4,12,5,1,25,16,63
"HLA-H",1,8,1,45,0,7,62
"SYP",12,11,7,14,11,7,62
"ETS1",1,23,2,16,8,11,61
"FASN",1,40,1,12,4,3,61
"IMPACT",1,36,3,8,2,11,61
"NOS2",6,35,1,2,2,15,61
"SP3",0,29,3,6,17,6,61
"CEACAM1",1,35,1,16,3,4,60
"E2F1",0,20,3,23,2,12,60
"ICAM1",1,25,0,16,8,10,60
"PDCD2",1,20,1,12,16,10,60
"SELE",0,44,0,7,5,4,60
"XRCC1",0,27,8,10,5,10,60
"CGA",1,25,13,5,7,8,59
"DAP",1,25,4,5,14,10,59
"DLC1",4,9,2,41,1,2,59
"NEUROD1",2,24,2,10,11,10,59
"PTP4A3",0,42,0,4,1,12,59
"SKP2",3,11,2,21,4,18,59
"TFF3",2,25,1,3,2,26,59
"CFLAR",4,28,2,15,5,4,58
"PPARA",0,19,1,37,0,1,58
"CXCR2",1,23,7,6,13,7,57
"IL19",5,14,3,20,4,11,57
"MAPK9",0,21,2,13,11,10,57
"PXN",1,28,2,12,8,6,57
"DKK1",1,22,2,12,8,11,56
"JAK2",1,23,4,9,5,14,56
"VIL1",1,41,3,2,2,7,56
"ZEB2",1,9,8,13,9,16,56
"CTGF",8,10,2,21,7,7,55
"CYP3A4",0,44,1,4,3,3,55
"GPT",0,19,11,7,5,13,55
"BID",2,26,12,2,4,8,54
"FGFR1",3,12,9,9,9,12,54
"HBD",35,8,3,3,3,2,54
"HMGB1",0,28,4,11,6,5,54
"IGF1",0,28,4,3,15,4,54
"KLRK1",2,23,2,13,5,9,54
"CCND2",4,15,4,10,9,11,53
"CHFR",3,25,7,1,0,17,53
"FGF2",1,19,2,11,10,10,53
"LGALS3",3,28,3,8,4,7,53
"PNP",1,27,2,5,13,5,53
"AREG",0,28,1,5,6,12,52
"CTSB",1,28,0,9,7,7,52
"SQSTM1",4,14,5,21,3,5,52
"ADAM17",3,15,3,12,6,12,51
"ALCAM",3,32,3,1,7,5,51
"ALOX5",1,24,3,7,11,5,51
"CLTC",7,3,0,40,0,1,51
"MBD2",4,23,6,8,1,9,51
"MSLN",4,4,1,3,36,3,51
"PSCA",6,0,3,1,8,33,51
"SNAI2",2,12,7,4,17,9,51
"F2R",9,10,1,17,6,7,50
"GPX1",2,18,5,15,4,6,50
"NAT1",0,34,0,6,5,5,50
"TP73",4,13,5,11,6,11,50
"KLF6",0,14,1,24,2,8,49
"PTH",3,22,3,2,9,10,49
"TNFRSF1A",3,26,3,9,4,4,49
"BLM",0,12,32,0,1,3,48
"CCR7",0,21,2,11,2,12,48
"FLG",0,19,2,16,2,9,48
"PLK1",3,16,5,12,5,7,48
"PTCH1",3,7,5,10,13,10,48
"SPARC",4,18,1,5,7,13,48
"ALDH1A1",2,20,6,8,8,3,47
"CACNA1G",1,44,0,1,0,1,47
"MID1",4,16,5,12,1,9,47
"RAD51",2,22,5,4,11,3,47
"TFF2",3,7,1,0,3,33,47
"ANXA2",3,16,3,11,10,3,46
"CA9",3,22,3,8,5,5,46
"CDC25A",2,17,3,15,2,7,46
"CTSD",0,24,1,6,4,11,46
"EGR1",2,21,3,12,1,7,46
"HPSE",1,11,3,15,2,14,46
"HSPB1",2,16,3,10,9,6,46
"M6PR",1,14,0,25,2,4,46
"PAH",1,23,14,4,2,2,46
"PDHX",4,0,1,1,40,0,46
"STK11",7,15,2,2,12,8,46
"CDC25C",0,22,2,10,3,8,45
"MUC3A",6,24,2,0,4,9,45
"S100P",13,9,1,1,11,10,45
"CLDN1",1,23,0,8,4,8,44
"CXCL1",0,16,1,8,9,10,44
"EZR",1,14,4,12,8,5,44
"IFNA1",0,20,2,14,3,5,44
"LEF1",2,37,1,3,0,1,44
"NTS",1,18,0,5,19,1,44
"PSMD10",5,3,0,34,1,1,44
"AURKA",1,21,3,4,8,6,43
"CD7",4,15,4,2,7,11,43
"MGA",5,18,6,4,1,9,43
"SFN",2,27,1,2,9,2,43
"SOCS3",5,12,1,20,2,3,43
"SOX9",6,21,3,5,1,7,43
"TH",2,13,5,10,2,11,43
"TIMP3",3,17,2,9,2,10,43
"BECN1",2,14,3,13,3,7,42
"BNIP3",1,14,4,6,14,3,42
"CBS",0,36,0,4,0,2,42
"HBEGF",2,12,1,5,8,14,42
"IDH1",33,3,0,6,0,0,42
"MARK2",2,15,5,8,6,6,42
"MAT1A",2,4,0,36,0,0,42
"NRAS",3,15,1,17,3,3,42
"TGFBR1",1,24,0,3,9,5,42
"WNT2",3,9,4,6,4,16,42
"CCNB1",3,15,1,14,3,5,41
"HMOX1",6,14,2,17,1,1,41
"HSPA5",2,13,5,12,4,5,41
"MAPK1",0,16,4,6,10,5,41
"PTGS1",1,32,1,4,1,2,41
"RECK",1,16,3,7,4,10,41
"STAT5A",0,16,5,12,4,4,41
"AGT",1,20,2,0,6,11,40
"ARL1",1,13,2,17,0,7,40
"DNMT3A",0,12,3,10,4,11,40
"DNMT3B",0,17,3,10,4,6,40
"FADD",2,13,4,10,7,4,40
"FGF19",3,9,5,18,3,2,40
"BMP4",2,19,3,5,3,7,39
"CDX1",0,29,0,0,0,10,39
"EIF2AK3",1,18,8,5,6,1,39
"ENPP1",1,5,0,3,28,2,39
"IRS1",0,17,0,15,6,1,39
"MALAT1",0,13,3,18,1,4,39
"RBP5",0,38,0,1,0,0,39
"SFRP2",2,24,2,4,2,5,39
"SSTR2",2,4,1,11,16,5,39
"TLR2",3,15,1,0,3,17,39
"ADH1B",0,8,23,2,2,3,38
"ATF3",0,28,1,4,3,2,38
"CDA",4,8,2,6,13,5,38
"CDK6",3,6,3,11,8,7,38
"DAPK1",5,16,1,1,2,13,38
"E2F4",0,19,3,7,0,9,38
"ILK",1,16,0,8,6,7,38
"MICA",0,11,1,18,3,5,38
"MUC5B",4,14,1,0,8,11,38
"PAM",0,17,3,3,10,5,38
"RAF1",2,20,3,6,5,2,38
"RHOC",1,8,0,14,7,8,38
"TDGF1",0,21,0,6,6,5,38
"TJP1",1,18,1,10,3,5,38
"TWIST1",5,11,2,12,2,6,38
"AURKB",1,16,2,8,7,3,37
"CLDN4",1,7,1,3,13,12,37
"GABRQ",3,17,2,5,0,10,37
"IL1RN",2,4,1,1,0,29,37
"MYD88",3,17,1,8,4,4,37
"PIM1",0,8,2,9,13,5,37
"PPARD",1,31,0,4,0,1,37
"S100A6",1,8,1,2,10,15,37
"SRY",4,5,8,9,5,6,37
"TIMP2",4,10,3,9,6,5,37
"CCL20",1,18,3,9,2,3,36
"CDKN2B",3,8,4,9,6,6,36
"IL6ST",5,7,2,11,6,5,36
"MAP1LC3A",1,14,3,13,2,3,36
"SOX17",2,12,5,3,6,8,36
"SPAG5",7,21,3,1,0,4,36
"STAT1",0,11,4,13,4,4,36
"STMN1",2,15,2,11,3,3,36
"ATG5",0,10,4,14,1,6,35
"CEACAM5",1,24,1,1,6,2,35
"CYP1A2",1,17,2,12,0,3,35
"EPHB4",1,20,2,8,1,3,35
"FURIN",0,20,0,7,4,4,35
"FZD1",1,13,4,4,2,11,35
"HNF1B",4,11,1,11,4,4,35
"KLF5",0,20,6,1,3,5,35
"PNMA2",6,10,2,5,6,6,35
"CLOCK",1,24,1,4,4,0,34
"CYP24A1",2,26,1,2,1,2,34
"GOLPH3",2,5,2,24,0,1,34
"H19",2,16,0,12,0,4,34
"IL24",1,8,0,17,4,4,34
"S100A8",2,14,5,0,5,8,34
"TWSG1",2,9,2,8,5,8,34
"CALU",1,19,1,1,4,7,33
"CCR5",0,9,1,13,6,4,33
"CDK2",0,19,0,11,2,1,33
"ELAVL1",0,14,2,9,3,5,33
"FBXW7",6,12,5,3,2,5,33
"MYCBP",0,17,2,7,1,6,33
"PAK1",0,12,1,8,6,6,33
"PTK7",2,15,4,2,3,7,33
"SDF4",3,19,0,3,5,3,33
"ABCB4",4,3,0,23,2,0,32
"ABCC2",6,10,2,12,0,2,32
"ALOX15",0,27,3,0,1,1,32
"AXIN1",1,14,0,13,0,4,32
"CCL16",2,1,0,24,1,4,32
"CCL5",0,11,1,4,8,8,32
"CSF2",2,19,0,5,5,1,32
"CYP1B1",2,14,3,10,2,1,32
"F2RL1",1,21,2,1,4,3,32
"FOXO1",1,9,2,9,7,4,32
"LBP",1,21,1,1,4,4,32
"LEPR",1,21,0,4,1,5,32
"MAT2A",0,5,0,26,0,1,32
"S100A9",2,15,4,0,3,8,32
"TFPI2",3,9,4,5,7,4,32
"CD82",0,13,1,5,6,6,31
"CXCL10",1,14,3,3,4,6,31
"FGFR4",2,13,2,3,5,6,31
"GAST",1,13,1,0,3,13,31
"HK2",1,22,1,1,5,1,31
"IHH",1,10,3,3,6,8,31
"IL17A",0,9,3,6,0,13,31
"IL1A",2,12,1,4,5,7,31
"NME1",0,16,0,10,0,5,31
"NQO1",1,18,3,8,0,1,31
"PER1",4,12,2,10,2,1,31
"REG4",1,10,0,1,2,17,31
"SLC2A1",2,15,4,1,6,3,31
"AKT2",1,3,2,8,11,5,30
"CAD",0,11,1,5,2,11,30
"CADM1",1,18,0,5,2,4,30
"CD69",0,11,1,13,2,3,30
"CEACAM6",0,18,0,3,5,4,30
"CIT",6,11,3,1,3,6,30
"ENO1",1,8,1,8,7,5,30
"GRPR",0,20,1,0,7,2,30
"NR1I2",1,13,0,15,1,0,30
"PLCE1",2,5,15,0,0,8,30
"PRB2",0,12,1,9,0,8,30
"SALL4",6,1,2,16,0,5,30
"SP4",0,12,2,2,14,0,30
"VTN",0,12,1,8,6,3,30
"WNT3",1,6,2,3,5,13,30
"WNT5A",0,15,1,2,5,7,30
"WWOX",6,3,2,8,4,7,30
"APEX1",3,12,1,3,5,5,29
"CDC25B",0,7,5,7,4,6,29
"CDH3",3,15,1,1,3,6,29
"CYP2A6",1,8,14,2,1,3,29
"DCK",6,2,0,1,18,2,29
"ERBB4",1,11,3,1,4,9,29
"FSCN1",0,11,7,3,3,5,29
"LCN2",0,11,1,6,8,3,29
"LIF",4,7,2,1,9,6,29
"MRE11",1,17,2,2,4,3,29
"PGF",2,15,3,3,3,3,29
"WNT10B",1,5,3,3,5,12,29
"XRCC5",0,10,8,5,1,5,29
"ABO",0,3,0,7,7,11,28
"AGR2",3,8,2,1,12,2,28
"ARG1",5,5,3,11,4,0,28
"CD163",3,12,3,6,0,4,28
"CLU",0,12,0,10,2,4,28
"CYP19A1",1,16,0,8,0,3,28
"DCLK1",3,15,1,3,4,2,28
"EIF4E",2,10,3,3,2,8,28
"FGF1",0,11,4,6,5,2,28
"MACC1",0,19,2,5,0,2,28
"NAA10",0,3,18,0,3,4,28
"NDRG2",2,13,0,8,3,2,28
"RUNX1",0,7,3,1,2,15,28
"RUNX2",1,7,2,1,4,13,28
"TLR9",0,9,3,7,2,7,28
"YAP1",2,4,8,7,5,2,28
"ACIN1",1,5,0,1,18,2,27
"ANXA1",4,4,4,7,4,4,27
"B2M",1,15,1,5,1,4,27
"CD2",2,14,1,2,1,7,27
"DVL1",0,13,3,3,3,5,27
"EIF4EBP1",2,13,2,6,2,2,27
"ESR1",4,18,0,3,2,0,27
"FZD7",0,5,4,7,2,9,27
"GNAS",7,5,1,4,9,1,27
"GNMT",1,0,0,25,0,1,27
"HELZ",0,15,3,4,2,3,27
"IL32",5,8,0,2,6,6,27
"LAPTM4B",2,5,3,15,0,2,27
"MTSS1",1,11,0,9,0,6,27
"NOD2",0,20,0,1,1,5,27
"PTHLH",0,11,1,5,7,3,27
"TEC",4,8,7,1,2,5,27
"THBS1",0,9,2,3,2,11,27
"TIMP1",0,7,1,6,9,4,27
"TYMP",2,13,1,2,0,9,27
"ABCB11",5,2,1,18,0,0,26
"AGER",3,7,3,2,9,2,26
"CASP8",1,10,3,3,3,6,26
"CSK",0,12,1,5,4,4,26
"DKK3",2,8,1,5,4,6,26
"ESD",1,3,15,0,0,7,26
"FYN",1,17,0,1,2,5,26
"GPC1",1,2,0,20,3,0,26
"HIC1",1,16,0,3,1,5,26
"HOTAIR",1,6,2,9,1,7,26
"HSF1",1,12,0,7,6,0,26
"ID1",1,6,7,6,2,4,26
"IGBP1",0,15,0,6,3,2,26
"IQGAP1",0,7,0,6,4,9,26
"KRT18",5,8,1,12,0,0,26
"MBP",4,12,1,1,1,7,26
"MIR122",0,1,0,24,0,1,26
"NES",2,3,0,2,15,4,26
"NF1",4,12,1,2,3,4,26
"NF2",1,14,0,3,2,6,26
"PI3",1,11,2,5,4,3,26
"PRDM2",2,3,0,16,3,2,26
"PROM1",2,16,0,3,0,5,26
"ROR2",0,8,3,1,4,10,26
"SERPINA3",1,3,1,10,5,6,26
"SRSF1",0,10,6,8,2,0,26
"ADIPOR1",1,15,0,2,1,6,25
"AES",3,9,0,12,0,1,25
"CD1A",2,14,2,3,1,3,25
"CFTR",0,8,0,2,14,1,25
"CTSA",0,10,0,8,3,4,25
"ENO2",1,4,4,5,5,6,25
"GPX2",0,14,2,7,0,2,25
"GRB2",2,5,1,4,4,9,25
"MRC1",1,11,0,6,2,5,25
"NR1H4",5,6,3,9,1,1,25
"OCLN",1,10,1,4,7,2,25
"OLFM4",2,10,0,0,1,12,25
"PKM",1,9,4,7,1,3,25
"RB1",1,8,3,7,4,2,25
"SATB1",1,9,3,6,0,6,25
"SERPINC1",1,1,2,12,1,8,25
"TAP1",0,13,5,2,1,4,25
"TCF4",1,16,2,3,0,3,25
"TEK",0,8,0,12,3,2,25
"TRDMT1",0,7,3,4,3,8,25
"TUBB3",1,7,4,2,2,9,25
"UGT1A7",0,15,0,6,1,3,25
"WT1-AS",1,10,2,6,4,2,25
"XRCC6",0,11,3,6,2,3,25
"AMACR",1,13,0,6,0,4,24
"ARID1A",6,3,0,2,3,10,24
"BAP1",12,4,1,4,2,1,24
"CD19",0,9,3,4,0,8,24
"CDKN1C",1,5,1,12,3,2,24
"CHEK1",0,19,2,1,1,1,24
"CSF2RB",1,10,0,10,1,2,24
"CYP2C9",0,18,3,1,0,2,24
"CYR61",1,2,1,4,5,11,24
"EBP",1,9,0,10,0,4,24
"EPHX1",0,6,7,10,1,0,24
"F10",0,15,1,7,1,0,24
"FOS",0,18,2,0,1,3,24
"FOXA2",1,5,1,5,7,5,24
"GPI",1,9,2,6,6,0,24
"HSPD1",1,9,1,4,3,6,24
"IGFBP7",1,13,1,6,2,1,24
"IL4",1,12,1,4,3,3,24
"KLK7",0,13,1,1,3,6,24
"LRP6",0,8,3,5,2,6,24
"MME",4,11,4,1,1,3,24
"NDRG1",1,6,2,6,2,7,24
"NR4A1",0,13,0,6,4,1,24
"PARP1",0,8,2,3,8,3,24
"SELP",0,19,0,3,1,1,24
"TMEFF2",4,14,1,1,0,4,24
"WNT7B",2,2,3,1,6,10,24
"ABCC3",1,6,0,10,6,0,23
"BIRC3",0,8,3,5,4,3,23
"BUB1",0,12,0,1,3,7,23
"CBL",0,7,2,0,2,12,23
"CCR2",1,8,0,6,3,5,23
"CKB",0,10,0,2,8,3,23
"EREG",1,13,2,4,1,2,23
"GFAP",1,5,3,7,5,2,23
"GKN1",0,0,0,0,0,23,23
"GLI2",1,7,1,0,9,5,23
"HLA-B",1,10,4,3,1,4,23
"IDH2",16,2,1,4,0,0,23
"IGF2BP3",5,3,5,8,2,0,23
"JAG1",0,9,1,4,3,6,23
"L1CAM",4,8,0,2,5,4,23
"LGALS4",0,9,2,7,4,1,23
"MMP3",3,5,4,7,2,2,23
"PALB2",0,1,0,0,22,0,23
"PTPN6",2,6,0,10,2,3,23
"SLC5A8",0,14,0,1,4,4,23
"XBP1",1,9,0,9,1,3,23
"XPC",2,7,4,4,3,3,23
"ADIPOR2",1,12,0,2,1,6,22
"APCS",0,15,0,7,0,0,22
"ARNT",0,17,1,2,0,2,22
"ATF4",1,11,2,4,1,3,22
"BSG",1,9,1,3,2,6,22
"CCL21",0,17,0,0,2,3,22
"EPHB2",0,16,0,0,2,4,22
"GIP",0,5,1,1,4,11,22
"IFITM1",1,3,3,5,3,7,22
"ING1",0,6,1,6,2,7,22
"PARK2",0,13,0,7,0,2,22
"PEBP1",3,10,0,5,2,2,22
"PGC",0,5,2,3,1,11,22
"PRKAR2B",2,10,1,3,3,3,22
"RHOB",0,10,0,0,4,8,22
"SERPINB5",3,11,0,5,0,3,22
"SFRP5",0,12,0,4,1,5,22
"TIAM1",0,13,2,4,1,2,22
"TNFRSF10A",3,10,2,6,1,0,22
"TNFRSF9",0,14,0,7,0,1,22
"VCAM1",0,10,0,8,1,3,22
"WIF1",1,11,2,4,1,3,22
"WNT5B",0,4,2,1,4,11,22
"ADH1C",0,8,7,2,2,2,21
"AKR1B1",0,10,1,8,1,1,21
"BTRC",0,11,0,7,1,2,21
"C8orf4",1,6,1,5,1,7,21
"CD40LG",3,8,0,6,1,3,21
"CD46",0,10,2,0,5,4,21
"FCGRT",1,9,1,8,1,1,21
"FGFR3",3,9,2,1,2,4,21
"FOXC2",1,5,4,0,5,6,21
"GDF15",0,11,1,4,1,4,21
"HLTF",1,15,0,1,0,4,21
"IRF1",0,9,0,6,1,5,21
"JUN",0,13,2,1,2,3,21
"KIAA1524",1,6,2,3,1,8,21
"LAMA1",0,12,0,5,1,3,21
"MAF",2,10,1,3,2,3,21
"MIR34A",3,6,0,6,3,3,21
"MTDH",1,6,1,11,0,2,21
"MYCN",0,8,2,3,1,7,21
"NCAM1",7,5,0,6,1,2,21
"PDGFRA",2,3,5,0,1,10,21
"PLAUR",0,8,0,5,1,7,21
"PTGER4",1,10,0,2,1,7,21
"SCGN",0,3,1,5,1,11,21
"SEPT9",2,18,0,0,0,1,21
"SLC4A3",1,2,11,0,2,5,21
"TAP2",0,12,3,2,1,3,21
"TRAF2",0,9,2,4,3,3,21
"TRAM1",0,9,1,3,6,2,21
"XAF1",0,12,1,1,1,6,21
"YY1",1,6,1,8,3,2,21
"ADAM10",0,5,1,6,4,4,20
"C8orf17",2,7,2,4,2,3,20
"CD276",0,9,0,5,5,1,20
"CISH",2,8,0,0,0,10,20
"CLDN3",0,7,0,1,3,9,20
"DNM2",0,5,2,7,1,5,20
"FUT3",3,7,0,3,4,3,20
"GSTA1",0,11,1,6,0,2,20
"GUCA2B",0,18,0,0,1,1,20
"GUCY2C",0,20,0,0,0,0,20
"HMGA2",3,6,4,4,1,2,20
"ITGAV",1,8,1,6,3,1,20
"KIR3DL1",1,6,1,8,1,3,20
"LPAR1",0,6,0,5,5,4,20
"LYVE1",0,7,0,5,1,7,20
"MBD4",0,13,1,1,2,3,20
"MIB1",1,7,0,7,2,3,20
"MIR221",1,7,1,8,2,1,20
"MYB",0,13,2,1,1,3,20
"NOX4",0,5,0,9,6,0,20
"OAT",1,9,0,3,6,1,20
"PML",3,10,2,1,1,3,20
"PPARG",0,17,1,0,1,1,20
"PTGER1",2,12,0,4,1,1,20
"RAD50",0,13,1,0,5,1,20
"RNF43",1,15,0,1,2,1,20
"SART3",0,9,4,5,0,2,20
"SPINK1",1,5,0,5,6,3,20
"SULF1",1,3,0,10,2,4,20
"TERF2IP",0,7,0,2,8,3,20
"UMPS",2,9,1,2,2,4,20
"UNC5C",0,16,0,1,0,3,20
"VHL",0,7,0,4,3,6,20
"VWF",0,14,1,1,1,3,20
"WNT8B",0,4,1,1,5,9,20
"WNT9B",0,3,2,0,5,10,20
"A2M",0,4,2,7,1,5,19
"ABCC1",2,4,2,2,5,4,19
"ADAM9",0,2,1,5,6,5,19
"AGTR1",0,4,2,5,3,5,19
"ATG7",0,6,4,8,0,1,19
"BIK",0,12,0,3,2,2,19
"BUB1B",1,10,0,4,1,3,19
"CACYBP",0,4,0,0,5,10,19
"CCND3",0,5,0,8,4,2,19
"CHEK2",0,13,3,0,1,2,19
"CLDN18",1,3,0,0,3,12,19
"CLDN2",0,5,2,5,4,3,19
"CYP27B1",1,18,0,0,0,0,19
"CYP3A5",0,10,1,7,0,1,19
"DICER1",1,7,1,3,1,6,19
"DLK1",1,3,0,14,0,1,19
"GADD45A",1,5,3,3,2,5,19
"GATA6",2,5,0,3,4,5,19
"GIF",1,4,8,0,0,6,19
"HPGD",0,13,1,2,0,3,19
"HPGDS",0,11,1,4,0,3,19
"HSP90B1",0,9,0,9,0,1,19
"KEAP1",1,10,0,5,3,0,19
"LIN28A",1,2,3,8,3,2,19
"MAP2K4",0,4,1,3,8,3,19
"MIR17HG",1,6,1,4,2,5,19
"MST1",0,7,1,7,2,2,19
"MTRR",0,11,1,2,2,3,19
"NOX1",0,16,0,2,0,1,19
"PGK1",2,6,0,6,1,4,19
"PTER",0,7,2,4,3,3,19
"ROCK1",0,14,0,5,0,0,19
"SOD2",1,4,1,5,5,3,19
"SOX4",3,3,5,5,0,3,19
"TCF7",0,18,0,1,0,0,19
"TFPI",2,7,0,4,4,2,19
"XPO1",1,10,2,4,1,1,19
"APOB",2,7,2,5,0,2,18
"ATP7B",0,5,1,9,0,3,18
"CCL3",0,8,0,1,5,4,18
"CCR4",0,9,2,0,1,6,18
"CD22",0,15,0,1,1,1,18
"CFB",1,3,0,10,1,3,18
"COPS5",2,2,0,10,2,2,18
"CSE1L",0,14,1,2,0,1,18
"CXCL2",1,10,2,0,1,4,18
"DDIT3",0,9,0,6,0,3,18
"DKK4",0,9,0,3,2,4,18
"ESAM",0,12,0,2,2,2,18
"FZD10",0,8,1,0,2,7,18
"GREM1",0,12,1,0,1,4,18
"GSTM3",1,6,2,7,0,2,18
"HDC",0,4,1,0,3,10,18
"HEY1",0,5,0,1,6,6,18
"HMGA1",2,10,2,3,0,1,18
"IRS2",0,11,0,3,2,2,18
"LCK",0,15,0,2,0,1,18
"LRP5",0,8,1,3,2,4,18
"MAGEC2",2,4,2,8,1,1,18
"MIR27A",0,8,3,0,5,2,18
"MLH3",0,17,0,0,0,1,18
"MMP13",0,11,2,4,0,1,18
"MSN",1,6,0,4,3,4,18
"NPS",0,8,0,6,1,3,18
"PBX2",0,9,0,0,3,6,18
"PDPN",1,9,3,2,1,2,18
"PEG10",2,0,1,14,1,0,18
"PLG",1,9,1,0,4,3,18
"PNPLA3",0,0,0,18,0,0,18
"SOD1",1,7,1,4,2,3,18
"STS",0,10,2,0,3,3,18
"SUFU",0,5,3,0,3,7,18
"TBX21",1,5,2,0,1,9,18
"TGFA",0,4,1,9,2,2,18
"TLR3",0,11,2,3,1,1,18
"UNC5B",0,16,0,1,0,1,18
"VANGL1",0,4,1,1,4,8,18
"WNT8A",0,3,1,0,4,10,18
"XRCC3",0,6,2,5,2,3,18
"AGO2",0,5,2,7,0,3,17
"BDNF",2,9,1,0,1,4,17
"CASR",0,10,3,2,0,2,17
"CXCL16",0,8,1,3,4,1,17
"CXCR3",1,7,0,5,0,4,17
"CYP2C19",0,4,4,6,1,2,17
"DCN",1,6,0,4,1,5,17
"DLL4",1,9,0,0,3,4,17
"DPP4",0,15,1,1,0,0,17
"FASLG",0,8,0,5,4,0,17
"FOXL1",0,2,2,0,7,6,17
"FST",0,4,2,5,1,5,17
"GADD45B",0,7,0,4,4,2,17
"GLUL",0,0,0,17,0,0,17
"HDAC2",1,9,0,2,0,5,17
"HGD",1,4,9,0,0,3,17
"HHIP",0,4,2,2,5,4,17
"IER3",0,9,0,2,3,3,17
"IFNG",0,5,3,5,2,2,17
"JAG2",0,3,3,0,4,7,17
"MAP3K1",0,8,1,2,3,3,17
"MAP3K7",0,7,1,2,3,4,17
"NEUROG1",1,16,0,0,0,0,17
"PHLPP1",0,11,1,0,3,2,17
"PMS1",2,15,0,0,0,0,17
"POSTN",1,5,4,3,2,2,17
"PRSS1",0,0,0,1,16,0,17
"PSMB8",0,6,4,3,1,3,17
"PTTG1",1,7,1,7,1,0,17
"RHOU",0,4,1,2,4,6,17
"RRM2",1,7,0,2,6,1,17
"SERPINE1",1,4,2,6,2,2,17
"SULT1A1",0,13,1,0,1,2,17
"TFF1",0,2,0,0,0,15,17
"TNFRSF25",1,7,2,4,2,1,17
"TRPC6",0,2,1,2,10,2,17
"TSPAN8",0,10,1,2,3,1,17
"UGT1A6",1,11,0,4,0,1,17
"UNC5A",0,17,0,0,0,0,17
"WEE1",0,7,1,5,3,1,17
"XPA",0,8,6,0,2,1,17
"YY1AP1",1,3,2,9,1,1,17
"ATF6",1,3,3,6,1,2,16
"ATOH1",0,13,0,0,0,3,16
"AXL",2,6,2,0,2,4,16
"CD99",1,1,2,5,5,2,16
"CDK7",0,8,0,7,0,1,16
"CEL",1,5,1,3,5,1,16
"CIC",0,8,1,4,2,1,16
"CLDN7",0,12,0,0,2,2,16
"CPM",1,4,6,1,1,3,16
"DUSP1",1,7,1,5,2,0,16
"DUSP6",0,2,2,2,10,0,16
"FOXO3",0,9,1,2,3,1,16
"FPGS",0,15,0,1,0,0,16
"FUT1",0,11,0,0,2,3,16
"GLI3",0,9,0,0,3,4,16
"GRN",4,1,1,9,0,1,16
"HAVCR2",0,2,3,6,1,4,16
"IKBKB",0,8,1,0,5,2,16
"IKZF3",1,9,0,0,4,2,16
"IL31",0,1,0,3,0,12,16
"LAMP1",1,5,1,3,1,5,16
"LEP",1,11,1,0,0,3,16
"LMNA",0,9,1,3,1,2,16
"MIR143",0,12,0,1,1,2,16
"MTA1",1,3,5,3,2,2,16
"MTAP",3,3,0,4,3,3,16
"MUC16",3,2,1,0,10,0,16
"NHS",1,12,2,0,1,0,16
"NKD1",0,5,2,1,3,5,16
"NKD2",0,3,3,1,3,6,16
"NTSR1",0,9,1,0,6,0,16
"PBK",2,8,1,4,0,1,16
"PFN1",1,5,2,2,3,3,16
"PGP",1,8,0,5,1,1,16
"PKD1",1,4,1,1,5,4,16
"PRDX1",3,4,7,2,0,0,16
"RAG2",0,12,0,1,2,1,16
"RND3",0,7,1,4,0,4,16
"SKP1",1,7,2,2,1,3,16
"SLC12A3",1,6,1,2,2,4,16
"SPTBN1",0,3,1,6,2,4,16
"ST14",0,8,0,1,4,3,16
"ST3GAL3",0,11,0,3,1,1,16
"TIFA",0,9,0,5,1,1,16
"TSPO",0,7,3,5,0,1,16
"ANXA10",2,3,1,4,0,5,15
"CD33",0,7,1,2,2,3,15
"CDH13",3,7,1,1,2,1,15
"CIAPIN1",0,2,0,1,1,11,15
"CKS1B",1,2,2,9,0,1,15
"CSF1",0,4,1,5,4,1,15
"CTCF",0,10,0,2,1,2,15
"CTNNBL1",3,3,1,6,0,2,15
"CYP2D6",1,4,2,6,1,1,15
"CYP7A1",3,4,0,7,1,0,15
"DHH",0,3,2,1,4,5,15
"DKK2",2,4,1,2,2,4,15
"DLL1",0,7,0,2,2,4,15
"E2F2",1,6,3,4,0,1,15
"ENPP3",2,6,1,6,0,0,15
"EZH2",2,2,2,7,0,2,15
"FEN1",1,4,4,2,1,3,15
"FZD6",0,5,1,1,2,6,15
"GATA4",0,6,0,0,4,5,15
"GPX3",0,3,3,1,0,8,15
"HSPA8",0,7,1,3,2,2,15
"IL21",1,6,0,5,0,3,15
"JAK3",1,6,1,2,2,3,15
"LOXL2",2,4,2,3,2,2,15
"MED1",0,5,0,6,2,2,15
"METAP2",3,9,1,2,0,0,15
"NDE1",0,5,1,4,2,3,15
"PDPK1",0,6,3,2,1,3,15
"PNKD",3,0,2,8,1,1,15
"PPP2R1B",0,9,1,1,1,3,15
"PSMB9",0,9,1,2,1,2,15
"PTP4A1",0,10,0,3,1,1,15
"PTP4A2",2,9,0,2,1,1,15
"ROBO1",4,6,0,2,1,2,15
"RPS6KA1",0,10,1,2,1,1,15
"RYK",0,4,2,1,3,5,15
"S100A11",1,6,0,2,5,1,15
"SAV1",2,2,1,6,1,3,15
"SDC1",1,5,0,6,2,1,15
"SERPINA1",0,3,1,6,0,5,15
"TOP2A",0,4,0,2,2,7,15
"TPX2",0,5,3,3,3,1,15
"TYK2",1,5,2,3,2,2,15
"WISP1",1,3,2,1,3,5,15
"ZNRD1",0,0,2,0,0,13,15
"ABCC4",1,2,0,4,5,2,14
"AKAP12",0,8,1,3,0,2,14
"AKR1C1",0,8,2,3,1,0,14
"ANGPT1",0,7,1,1,3,2,14
"ANGPTL4",0,5,0,5,0,4,14
"ASPH",6,0,0,7,0,1,14
"CD101",0,7,1,0,0,6,14
"CD151",2,7,0,0,1,4,14
"CD38",0,8,2,2,2,0,14
"CLIC1",2,5,0,2,1,4,14
"CXCR1",0,5,1,2,3,3,14
"ENAH",0,4,0,2,5,3,14
"ENDOG",0,9,0,2,0,3,14
"FAT1",0,3,4,2,2,3,14
"FHL2",1,11,0,0,0,2,14
"FOXF1",0,2,3,3,3,3,14
"FRZB",0,7,0,1,1,5,14
"GTF2H3",1,6,1,2,1,3,14
"JAK1",1,4,1,6,1,1,14
"KLK10",0,7,1,1,1,4,14
"KLK3",1,7,0,3,2,1,14
"KRT17",6,2,0,1,5,0,14
"MAP3K5",0,5,1,5,2,1,14
"MAPK14",0,12,0,2,0,0,14
"MICB",0,6,0,6,2,0,14
"MIR375",0,3,4,4,1,2,14
"MUC13",1,5,1,0,1,6,14
"NUAK1",1,8,0,2,3,0,14
"PAX8",2,2,0,3,5,2,14
"PER2",0,12,0,2,0,0,14
"PGR",3,7,0,0,0,4,14
"PPA1",0,5,0,3,2,4,14
"PPARGC1A",0,4,0,10,0,0,14
"PRNP",0,6,1,0,0,7,14
"RDX",1,7,0,3,1,2,14
"ROS1",7,3,0,1,0,3,14
"RRM1",4,6,0,1,3,0,14
"SHC1",0,7,0,3,4,0,14
"SLC22A16",2,3,7,0,0,2,14
"SLC7A5",2,6,0,3,1,2,14
"SMYD3",3,4,1,4,1,1,14
"SULF2",0,2,0,8,1,3,14
"TNFRSF6B",1,2,0,2,6,3,14
"TXNIP",0,5,1,5,1,2,14
"UCHL1",5,1,1,1,4,2,14
"UCP2",0,6,0,5,3,0,14
"VCAN",0,4,1,4,3,2,14
"WNT11",0,4,2,1,2,5,14
"ABCC5",0,3,2,3,5,0,13
"ALOX12",0,9,1,1,1,1,13
"BCAR1",0,7,0,2,2,2,13
"BIRC2",0,8,2,2,1,0,13
"CDCP1",0,7,2,0,2,2,13
"CTNNA1",0,9,0,1,0,3,13
"CUX1",0,2,2,2,6,1,13
"CXCL12",1,3,0,1,5,3,13
"CXCR6",0,6,0,4,3,0,13
"E2F3",0,6,0,5,2,0,13
"EBAG9",2,2,0,5,2,2,13
"FABP1",1,5,0,5,0,2,13
"FANCD2",3,1,2,2,5,0,13
"FUT2",2,6,0,2,2,1,13
"FZD5",0,3,1,0,2,7,13
"GH1",0,6,0,4,1,2,13
"GKN2",0,0,0,0,0,13,13
"GLYAT",0,6,1,1,3,2,13
"GNB2L1",0,5,0,6,1,1,13
"HDAC6",2,5,0,2,2,2,13
"HTRA2",0,6,0,3,1,3,13
"KDM1A",0,9,1,2,1,0,13
"LPAR2",0,7,0,1,3,2,13
"MDK",1,5,1,3,0,3,13
"MMP10",0,5,0,4,0,4,13
"MNT",3,0,0,8,1,1,13
"MUC12",1,8,1,0,1,2,13
"NME2",0,6,0,5,1,1,13
"NR1I3",1,3,0,9,0,0,13
"PIP",0,5,0,6,0,2,13
"PPP1R1B",0,0,0,0,0,13,13
"RASA1",1,5,0,4,2,1,13
"RBPJ",1,4,0,0,4,4,13
"REG3A",1,1,0,7,3,1,13
"RICTOR",1,6,1,2,1,2,13
"RPTOR",0,7,0,3,0,3,13
"S100A10",1,8,1,1,0,2,13
"SFTPC",0,3,2,5,0,3,13
"SLCO1B3",0,2,0,7,4,0,13
"SPHK1",1,9,0,0,0,3,13
"STK4",0,7,1,2,1,2,13
"TKT",1,8,1,0,1,2,13
"TLR7",0,8,2,2,1,0,13
"TM4SF5",0,2,1,9,1,0,13
"TMPRSS4",1,6,0,1,0,5,13
"TOP1",1,9,0,1,1,1,13
"TSPAN1",0,4,0,4,1,4,13
"WNT2B",0,3,1,0,0,9,13
"ZNF217",0,7,2,0,1,3,13
"ACSL4",0,3,0,9,0,0,12
"ADAM12",2,1,0,4,2,3,12
"ADH4",0,3,6,2,1,0,12
"AKR1C2",0,4,2,5,0,1,12
"ALDH3A1",0,6,0,2,4,0,12
"ALPK2",1,1,0,8,1,1,12
"ANKRD36B",0,7,3,1,1,0,12
"ANO1",0,1,4,2,2,3,12
"APC2",0,12,0,0,0,0,12
"ARL4C",1,7,0,2,1,1,12
"ASCL2",0,9,0,1,1,1,12
"BCL10",1,3,0,3,3,2,12
"C2orf40",0,1,11,0,0,0,12
"CD81",0,5,1,3,2,1,12
"CDC20",0,5,1,2,2,2,12
"CDC6",2,3,0,1,1,5,12
"CHD1",0,2,0,7,1,2,12
"CTRL",0,2,0,6,1,3,12
"CXCL9",1,2,1,3,1,4,12
"DYRK1B",0,4,0,0,8,0,12
"EIF2A",0,6,0,4,1,1,12
"ERAS",1,2,2,3,1,3,12
"FUT6",0,4,0,5,3,0,12
"GPX4",0,6,1,3,1,1,12
"GSTM2",0,4,0,4,1,3,12
"HAS2",0,9,1,2,0,0,12
"HDAC9",0,4,0,4,2,2,12
"HES5",0,4,0,0,4,4,12
"IFNAR1",0,3,0,8,0,1,12
"IL2RA",0,3,1,2,1,5,12
"KIF27",0,3,1,0,4,4,12
"KIF7",0,3,1,0,4,4,12
"LAMC2",2,5,0,2,1,2,12
"LIN28B",0,4,0,6,2,0,12
"LPL",0,9,0,1,1,1,12
"MGAT5",0,3,0,7,0,2,12
"MLN",2,0,6,0,1,3,12
"MLPH",3,2,4,2,0,1,12
"MMP11",0,4,0,2,1,5,12
"MMP12",0,8,1,1,0,2,12
"MT2A",0,3,1,4,0,4,12
"NAMPT",0,5,1,1,1,4,12
"NDC80",1,5,1,3,1,1,12
"NEK2",3,4,0,3,2,0,12
"NOTCH2",2,5,0,2,1,2,12
"NR4A2",0,7,0,2,1,2,12
"NUDT1",1,9,0,1,0,1,12
"ODC1",0,10,1,0,0,1,12
"P4HB",1,4,1,1,1,4,12
"PECAM1",0,6,1,3,0,2,12
"PLA2G2A",0,9,0,0,0,3,12
"PLD2",0,8,1,0,0,3,12
"PRKDC",0,5,1,2,2,2,12
"PTGER2",1,8,0,1,0,2,12
"PTPN11",0,2,0,1,1,8,12
"RALA",0,4,1,2,5,0,12
"ROR1",0,3,1,0,2,6,12
"SCD",0,6,4,1,0,1,12
"SERPINB6",4,4,2,0,1,1,12
"SGK1",0,10,0,1,1,0,12
"SIX1",0,3,2,4,2,1,12
"SLA",0,3,5,0,0,4,12
"SLC22A1",3,1,0,7,1,0,12
"SLC9A3R1",0,5,0,3,3,1,12
"SLCO1B1",0,2,0,8,2,0,12
"SMO",0,5,0,2,3,2,12
"TGFBI",2,3,0,2,4,1,12
"TMEM8B",0,10,0,0,0,2,12
"TNC",0,6,2,0,4,0,12
"TP53BP1",0,6,2,1,2,1,12
"TRIM33",1,7,0,2,2,0,12
"TSC2",1,5,0,5,1,0,12
"TXN",1,3,0,6,0,2,12
"VANGL2",0,2,1,0,4,5,12
"ZBTB10",0,7,0,0,4,1,12
"ADAM8",0,0,1,4,3,3,11
"ALDOA",0,1,1,8,0,1,11
"AQP3",0,3,0,1,2,5,11
"ARHGEF4",0,11,0,0,0,0,11
"C4A",0,9,0,1,1,0,11
"CCR3",0,5,0,4,0,2,11
"CDC37",0,2,0,3,6,0,11
"CDK8",0,10,0,0,0,1,11
"CHD1L",0,1,0,10,0,0,11
"CYBB",0,7,1,2,1,0,11
"DDR1",1,4,2,3,1,0,11
"DMBT1",2,4,3,1,1,0,11
"EEF1A1",0,7,1,2,1,0,11
"EFNB1",1,5,1,0,1,3,11
"EFNB2",1,6,1,0,1,2,11
"ENPP2",0,5,0,6,0,0,11
"EPHA7",1,6,0,3,0,1,11
"EPOR",0,2,0,5,0,4,11
"FAT4",1,1,2,2,2,3,11
"FGF18",0,6,0,2,1,2,11
"FOXA1",0,1,4,5,1,0,11
"FZD3",0,2,0,0,2,7,11
"GAB1",2,4,0,3,0,2,11
"GADD45G",0,2,1,4,3,1,11
"GHR",0,6,1,3,0,1,11
"GIPC1",0,4,0,0,3,4,11
"GJB2",0,4,0,5,1,1,11
"HDAC3",0,2,0,5,1,3,11
"HES7",0,4,0,0,4,3,11
"HEY2",0,4,0,0,3,4,11
"HEYL",0,3,0,1,3,4,11
"HINT1",0,6,0,3,1,1,11
"IFNL3",0,0,0,11,0,0,11
"ING4",0,4,0,2,3,2,11
"ITGA1",0,7,0,1,1,2,11
"KISS1",0,3,1,2,3,2,11
"KRT4",0,4,4,1,1,1,11
"LATS2",0,2,1,3,2,3,11
"LDLR",2,4,0,1,1,3,11
"LPAR3",0,5,0,1,4,1,11
"MAP1LC3B",0,4,4,2,0,1,11
"MEG3",1,1,3,6,0,0,11
"MGAT3",0,2,0,8,0,1,11
"MIR25",1,2,1,3,0,4,11
"MT1G",0,5,0,5,1,0,11
"MYOD1",0,6,1,1,0,3,11
"NACA",1,6,0,3,0,1,11
"NEDD9",0,4,1,4,0,2,11
"NGFR",0,3,1,2,4,1,11
"NLRP3",0,4,0,3,0,4,11
"NPY",1,4,3,0,2,1,11
"OGFR",0,4,0,2,5,0,11
"PCDH10",0,3,2,1,1,4,11
"PDCD6",1,2,0,4,2,2,11
"PIK3R1",1,5,1,2,1,1,11
"PMAIP1",0,2,2,4,3,0,11
"PPM1D",0,4,0,4,1,2,11
"PROX1",1,2,2,3,2,1,11
"PTPRJ",0,7,1,1,1,1,11
"RASSF2",0,4,1,2,1,3,11
"ROCK2",1,3,0,6,0,1,11
"RPS18",0,9,1,0,1,0,11
"RPS6KB1",0,4,1,2,3,1,11
"SAA1",1,4,0,6,0,0,11
"SFRP4",2,4,2,2,1,0,11
"SLC19A1",0,7,1,0,0,3,11
"SMARCA1",0,4,0,2,0,5,11
"SPG7",1,4,0,2,0,4,11
"ST7",0,2,2,1,0,6,11
"STARD13",0,1,0,9,1,0,11
"STAT6",0,11,0,0,0,0,11
"SUZ12",2,4,0,3,0,2,11
"TKTL1",0,7,0,1,0,3,11
"TNFRSF1B",0,7,2,1,1,0,11
"TNS4",0,4,0,1,4,2,11
"TPO",0,5,1,1,1,3,11
"TPR",0,1,0,3,1,6,11
"TUBB",1,6,1,0,1,2,11
"UHRF1",1,7,1,1,0,1,11
"VEGFB",0,6,0,2,1,2,11
"ACAA1",0,4,1,1,2,2,10
"AFM",2,1,3,0,1,3,10
"AKT3",1,2,1,5,0,1,10
"ALDOB",0,0,0,9,0,1,10
"AMN",1,4,1,1,2,1,10
"AQP5",1,3,0,1,2,3,10
"BCL2L12",0,4,0,0,0,6,10
"BOC",1,6,0,3,0,0,10
"CALR",0,4,2,2,1,1,10
"CCL22",0,3,1,3,0,3,10
"CCL7",0,6,0,0,1,3,10
"CCNA1",0,4,1,2,1,2,10
"CCNA2",0,4,0,5,0,1,10
"CCNG1",0,3,0,5,1,1,10
"CCNG2",0,4,3,1,1,1,10
"CCR1",0,2,1,7,0,0,10
"CD27",0,3,1,5,0,1,10
"CDC7",0,6,0,0,2,2,10
"CDH5",1,3,4,1,0,1,10
"CHGA",0,3,0,0,4,3,10
"COIL",1,4,2,2,1,0,10
"COL14A1",2,4,0,1,3,0,10
"CRK",0,5,0,0,1,4,10
"CTSE",0,3,0,1,3,3,10
"CTTN",0,2,1,3,3,1,10
"DNER",1,3,0,0,0,6,10
"DUOX2",0,3,0,2,3,2,10
"DVL2",0,6,1,0,1,2,10
"EFNA1",0,3,2,2,2,1,10
"EFNA3",0,4,1,2,2,1,10
"EGFL7",0,4,1,4,0,1,10
"ELF4",0,6,0,1,0,3,10
"EMP1",1,2,2,0,3,2,10
"ERCC4",0,2,2,0,1,5,10
"EXO1",0,8,0,0,0,2,10
"FMN1",0,5,0,0,3,2,10
"FOXP2",0,1,1,4,2,2,10
"FOXQ1",0,3,1,2,2,2,10
"GIPC2",0,2,0,0,3,5,10
"GIPC3",0,2,0,0,3,5,10
"GJB1",0,3,0,5,0,2,10
"GPA33",0,8,1,0,0,1,10
"GSC",2,4,1,0,0,3,10
"GSR",0,6,1,1,0,2,10
"GSTO1",2,2,1,4,1,0,10
"HAMP",0,2,0,8,0,0,10
"HOXB7",2,3,2,0,2,1,10
"HSPH1",0,7,1,2,0,0,10
"IL18",0,4,0,6,0,0,10
"ING2",0,6,0,3,0,1,10
"LAMA2",3,5,0,1,1,0,10
"LIMK1",0,6,0,1,1,2,10
"MAP2K2",1,3,0,2,4,0,10
"MAP2K3",0,5,0,1,4,0,10
"MARCKS",1,5,0,2,2,0,10
"MBL2",0,6,0,2,0,2,10
"MCM7",0,3,2,3,1,1,10
"MIR141",1,1,3,2,3,0,10
"MIR29A",0,4,1,3,1,1,10
"MMP1",0,1,0,4,1,4,10
"NCL",2,4,0,0,1,3,10
"NPTX2",2,0,0,0,8,0,10
"NUMB",0,5,2,1,1,1,10
"OCA2",1,4,0,2,1,2,10
"ONECUT1",0,3,0,4,3,0,10
"ORM1",0,3,1,5,0,1,10
"PAK4",1,3,0,2,2,2,10
"PARK7",1,2,0,1,4,2,10
"PCM1",1,3,0,1,5,0,10
"PDLIM4",0,7,0,1,1,1,10
"PIN1",0,2,2,5,0,1,10
"PLEK",0,7,0,1,1,1,10
"POT1",0,2,0,2,1,5,10
"PRKD1",0,1,0,0,5,4,10
"PTPN13",0,7,1,1,0,1,10
"RAD1",0,5,1,0,2,2,10
"RALGDS",0,5,0,3,2,0,10
"RBP2",0,3,1,1,0,5,10
"RELB",0,2,0,1,7,0,10
"RGN",0,0,0,10,0,0,10
"RPS6",0,3,0,5,2,0,10
"S100A2",0,1,1,0,4,4,10
"SEMA3B",2,2,0,2,0,4,10
"SIRT6",0,4,1,3,2,0,10
"SMURF1",0,1,0,3,5,1,10
"SOCS6",0,2,0,3,1,4,10
"SPN",1,1,1,0,6,1,10
"SRF",0,3,0,3,1,3,10
"SSTR1",1,3,0,2,3,1,10
"ST6GAL1",0,5,0,3,0,2,10
"STAT2",1,2,0,7,0,0,10
"STC1",0,7,1,1,1,0,10
"TAC1",0,6,1,1,1,1,10
"TBX3",0,3,0,4,2,1,10
"TNFAIP3",1,2,5,1,0,1,10
"TNFRSF12A",0,2,0,7,0,1,10
"TNFRSF18",0,3,1,5,0,1,10
"TNIK",0,8,0,0,0,2,10
"TPM1",1,3,2,1,1,2,10
"TRPV6",0,6,1,0,2,1,10
"TWIST2",0,2,1,2,2,3,10
"YWHAZ",1,2,1,1,1,4,10
"ZNF148",0,6,0,2,1,1,10
"ADIPOQ",0,7,1,1,0,0,9
"AIM2",0,8,0,0,0,1,9
"AIMP1",0,4,0,2,1,2,9
"ALOX5AP",0,5,1,1,1,1,9
"ALX4",1,7,0,1,0,0,9
"APAF1",0,6,0,2,0,1,9
"ATF2",1,3,0,4,0,1,9
"BAG3",0,5,1,2,0,1,9
"BGN",1,3,0,1,2,2,9
"BMP2",0,4,0,1,3,1,9
"CALB2",0,7,0,0,2,0,9
"CCR9",0,3,1,1,4,0,9
"CD58",0,7,0,0,1,1,9
"CDK9",0,4,0,4,1,0,9
"CDKN2B-AS1",1,1,1,2,1,3,9
"CHL1",2,3,1,3,0,0,9
"DAAM1",0,1,1,0,4,3,9
"DAAM2",0,1,1,0,4,3,9
"DACH1",0,6,1,0,1,1,9
"DRD2",0,5,1,1,1,1,9
"EED",1,3,2,2,0,1,9
"EFEMP1",0,3,0,3,2,1,9
"EFNA2",0,4,1,1,2,1,9
"EGLN1",1,4,0,2,0,2,9
"EIF5A",0,4,1,2,1,1,9
"EPHA2",1,4,0,1,2,1,9
"FANCA",1,1,1,1,5,0,9
"FMNL2",0,5,0,0,3,1,9
"FRAT2",0,1,1,0,2,5,9
"GLA",0,1,0,7,0,1,9
"GOLM1",1,0,2,5,1,0,9
"GP2",1,2,0,1,5,0,9
"GUCA2A",0,7,0,0,1,1,9
"GYPC",0,2,1,4,1,1,9
"HAS3",0,8,1,0,0,0,9
"HSPA1A",0,6,0,2,1,0,9
"ID2",0,4,0,3,1,1,9
"ID4",2,4,0,0,0,3,9
"IFNAR2",1,0,2,3,2,1,9
"IGFBP1",1,4,0,1,1,2,9
"IL1R1",0,4,0,2,1,2,9
"IL23R",0,4,1,1,0,3,9
"IQGAP2",0,0,0,7,0,2,9
"ITGB2",0,2,0,2,2,3,9
"JARID2",0,5,3,1,0,0,9
"KLF8",0,0,0,4,0,5,9
"KLK6",1,6,1,0,1,0,9
"LGALS1",1,3,0,3,1,1,9
"LYZ",2,1,0,4,0,2,9
"MAGEC1",1,3,2,2,0,1,9
"MAP3K14",1,0,1,3,3,1,9
"MDM4",0,5,0,3,0,1,9
"MGP",0,3,1,1,1,3,9
"MITF",1,4,0,2,2,0,9
"MTA2",0,4,0,2,1,2,9
"NCR3",0,4,0,3,1,1,9
"NFATC2",0,5,1,1,2,0,9
"NNMT",0,2,0,3,2,2,9
"NOD1",0,4,0,0,0,5,9
"NOS3",0,3,0,2,1,3,9
"NOTCH3",0,1,1,5,2,0,9
"PBRM1",5,1,0,2,1,0,9
"PHB2",0,3,0,3,1,2,9
"PTPN3",2,4,0,1,0,2,9
"RGMA",0,8,0,0,0,1,9
"RIPK1",0,3,1,3,2,0,9
"SCGB2A1",0,2,0,0,0,7,9
"SELENBP1",0,3,0,3,0,3,9
"SERPINE2",0,4,1,1,3,0,9
"SLC22A3",1,3,1,3,1,0,9
"SLC7A1",1,4,0,4,0,0,9
"SOX7",0,4,1,0,2,2,9
"SPARCL1",1,5,0,1,1,1,9
"SPHK2",0,7,0,1,0,1,9
"SSTR3",1,2,2,4,0,0,9
"ST8SIA4",1,1,3,2,1,1,9
"SUV39H1",0,4,0,3,2,0,9
"TAGLN2",0,4,1,2,1,1,9
"TERC",0,2,1,2,2,2,9
"TFAP4",0,6,0,0,2,1,9
"TRAF6",0,1,2,2,1,3,9
"TUSC2",1,3,0,3,1,1,9
"TUSC3",1,2,1,2,3,0,9
"UHRF2",0,5,0,2,1,1,9
"ULBP2",1,5,0,0,1,2,9
"ACOX1",0,1,0,7,0,0,8
"ACTN4",0,4,3,1,0,0,8
"ADAR",0,2,1,5,0,0,8
"ALPI",0,8,0,0,0,0,8
"APOBEC1",0,3,0,5,0,0,8
"APOBEC3G",0,2,0,6,0,0,8
"APOE",1,3,0,1,0,3,8
"BCL6",0,2,2,0,1,3,8
"CCL17",0,5,0,1,0,2,8
"CCL19",0,5,0,1,1,1,8
"CCNC",0,3,0,3,0,2,8
"CCNE2",0,4,0,3,1,0,8
"CDK14",0,0,1,6,0,1,8
"CDKN3",0,1,1,5,0,1,8
"CDO1",3,3,2,0,0,0,8
"CENPS",0,3,2,2,0,1,8
"CIB1",0,1,1,5,0,1,8
"CLPTM1L",0,3,2,0,3,0,8
"CRKL",0,2,0,2,0,4,8
"CRX",0,4,2,1,0,1,8
"CSRP1",0,4,0,2,0,2,8
"CTLA4",0,3,0,1,1,3,8
"CYLD",1,0,1,5,0,1,8
"CYP17A1",0,4,0,0,2,2,8
"CYP2W1",0,7,0,0,0,1,8
"CYP3A7",0,1,1,6,0,0,8
"CYP51A1",0,2,1,4,1,0,8
"DCX",0,5,0,2,1,0,8
"DDX5",0,4,1,1,1,1,8
"DFFA",0,5,1,1,0,1,8
"DR1",0,0,1,5,1,1,8
"DSG2",0,4,0,0,2,2,8
"DVL3",0,2,2,1,1,2,8
"DZIP1",0,2,1,0,2,3,8
"ECM1",1,1,0,2,3,1,8
"EEF2",0,4,0,0,1,3,8
"EHMT2",0,3,0,1,3,1,8
"EIF5A2",0,3,0,5,0,0,8
"EML4",0,6,1,0,0,1,8
"EPGN",0,1,2,1,0,4,8
"ERN1",0,1,1,5,1,0,8
"ERRFI1",1,1,2,2,2,0,8
"ETS2",0,2,1,0,4,1,8
"ETV4",0,5,0,0,1,2,8
"ETV5",0,4,0,1,1,2,8
"FAM3B",0,2,0,3,2,1,8
"FANCC",0,0,0,1,7,0,8
"FAT2",0,1,2,1,2,2,8
"FOLR1",0,5,1,1,1,0,8
"FOXP1",0,2,1,3,1,1,8
"FUT4",0,4,0,1,1,2,8
"FZD8",0,3,0,0,1,4,8
"GAGE1",0,1,0,4,2,1,8
"GLG1",0,1,0,2,1,4,8
"GMNN",0,4,0,1,2,1,8
"HEXA",1,2,0,4,0,1,8
"HIPK2",0,6,0,2,0,0,8
"HLA-C",1,6,0,1,0,0,8
"HNF4A",1,1,0,5,1,0,8
"HOXA10",0,0,1,0,1,6,8
"HOXD10",0,2,1,1,0,4,8
"HSPA9",0,5,0,3,0,0,8
"ICOS",0,4,0,1,1,2,8
"IFNA2",0,4,0,3,0,1,8
"IFNGR1",0,4,1,1,0,2,8
"IGFBP2",0,3,2,0,2,1,8
"IL17F",0,1,0,2,0,5,8
"IL6R",0,4,1,3,0,0,8
"ITGA3",0,4,0,1,1,2,8
"ITGA5",0,7,0,1,0,0,8
"ITGB4",1,3,1,2,1,0,8
"KCNQ1",0,4,0,1,0,3,8
"KCNQ1OT1",0,2,1,3,0,2,8
"KIAA0101",1,0,1,3,1,2,8
"KIF20A",1,0,0,2,3,2,8
"LCT",0,6,2,0,0,0,8
"LGR4",1,4,0,0,0,3,8
"LYN",1,3,1,1,1,1,8
"MAP2K7",0,3,0,4,0,1,8
"MAZ",1,2,0,2,1,2,8
"MDC1",0,2,3,0,0,3,8
"MINA",0,3,2,1,0,2,8
"MIR148A",0,1,0,2,1,4,8
"MIR196A2",0,2,1,2,0,3,8
"MIR200A",0,1,1,4,1,1,8
"MIR200C",0,2,1,0,4,1,8
"MIR27B",0,3,1,3,1,0,8
"MMP15",0,4,1,2,0,1,8
"MSH3",0,7,1,0,0,0,8
"MT1F",0,3,0,3,1,1,8
"MUC15",0,4,0,1,2,1,8
"MUC7",1,2,1,2,1,1,8
"MYBL2",0,4,1,1,0,2,8
"NAPSA",2,2,0,3,0,1,8
"NBN",1,2,2,2,0,1,8
"NCK1",0,3,0,3,2,0,8
"NEDD4",0,3,0,1,2,2,8
"NEIL1",1,3,1,1,0,2,8
"NR5A2",1,2,1,0,4,0,8
"PAX6",0,3,0,0,2,3,8
"PDCD10",0,3,2,1,1,1,8
"PDGFRB",0,3,2,0,0,3,8
"PER3",0,4,0,2,2,0,8
"PHLPP2",0,6,1,0,1,0,8
"PLK3",1,3,1,2,0,1,8
"PLK4",0,2,0,6,0,0,8
"PRDX5",0,2,2,1,1,2,8
"PRTN3",0,2,2,2,1,1,8
"PTPRC",1,2,0,0,1,4,8
"PVR",1,4,0,1,1,1,8
"RAB25",0,4,1,1,0,2,8
"RBM15",2,2,2,1,1,0,8
"REG1A",1,3,1,2,1,0,8
"RPRM",0,0,2,2,2,2,8
"RUVBL1",0,5,0,2,0,1,8
"RUVBL2",0,4,0,3,0,1,8
"S100B",0,5,0,0,1,2,8
"SCN10A",0,1,5,0,0,2,8
"SCTR",2,4,0,1,1,0,8
"SDC2",1,5,0,2,0,0,8
"SEL1L",0,1,2,0,4,1,8
"SHMT1",0,6,1,1,0,0,8
"SOS1",0,2,0,2,1,3,8
"STH",0,6,0,1,0,1,8
"STK36",0,2,1,0,2,3,8
"TACC3",4,0,1,1,0,2,8
"TACSTD2",2,6,0,0,0,0,8
"TDG",0,4,1,0,1,2,8
"TNFRSF10D",1,6,0,1,0,0,8
"TPI1",0,2,1,2,3,0,8
"TRPV1",0,3,0,1,2,2,8
"UBC",1,3,0,3,1,0,8
"UBE2C",1,5,0,2,0,0,8
"ULBP1",1,3,0,2,0,2,8
"USP22",0,5,0,2,0,1,8
"WNT6",0,1,0,0,1,6,8
"WNT9A",0,2,0,0,2,4,8
"XRCC4",0,2,3,1,0,2,8
"YBX1",0,5,0,2,0,1,8
"ZBTB7A",0,1,0,7,0,0,8
"ZFHX3",0,0,0,2,0,6,8
"ABCE1",0,3,1,2,1,0,7
"ADAMTS1",0,3,0,2,0,2,7
"AKTIP",0,2,1,1,3,0,7
"AMBP",1,1,1,2,0,2,7
"ANPEP",1,4,0,2,0,0,7
"ANXA4",2,5,0,0,0,0,7
"ANXA5",0,3,0,3,0,1,7
"APPL1",0,2,0,2,2,1,7
"ARHGDIA",0,3,0,3,0,1,7
"ARNTL",0,6,0,1,0,0,7
"ASAH1",0,1,2,1,3,0,7
"ASNS",0,1,1,2,2,1,7
"ATP7A",0,5,0,1,0,1,7
"BCL2L10",0,1,0,0,0,6,7
"BCL9L",0,6,0,0,1,0,7
"BHLHE41",0,2,1,0,3,1,7
"C19orf26",0,1,2,2,2,0,7
"CAPG",0,3,0,2,1,1,7
"CARD18",0,3,0,1,1,2,7
"CASP1",0,4,0,1,0,2,7
"CD36",0,7,0,0,0,0,7
"CDC73",0,5,0,0,0,2,7
"CKS2",1,1,1,2,0,2,7
"CNR2",0,6,0,0,1,0,7
"COL11A1",0,3,2,0,1,1,7
"COL1A1",0,0,1,1,0,5,7
"COL1A2",1,1,0,1,0,4,7
"CR2",0,3,1,1,1,1,7
"CSF1R",0,5,0,1,1,0,7
"CST1",0,4,0,0,1,2,7
"CTAG2",0,4,1,1,1,0,7
"CTHRC1",0,2,1,1,1,2,7
"DACT1",0,3,1,1,0,2,7
"DLL3",0,2,0,1,2,2,7
"DNASE1",0,3,0,0,2,2,7
"DSC2",0,6,1,0,0,0,7
"DUOX1",0,3,0,3,1,0,7
"DUT",0,3,0,1,0,3,7
"E2F8",0,2,1,3,0,1,7
"EGLN3",0,5,0,0,1,1,7
"ENPEP",0,3,1,1,0,2,7
"EP300",0,4,0,0,2,1,7
"EPAS1",0,1,1,3,2,0,7
"EPHA3",0,4,1,0,1,1,7
"EPHB3",0,5,0,0,0,2,7
"ESM1",0,3,0,3,0,1,7
"FANCF",2,1,0,1,3,0,7
"FAT3",0,1,1,1,2,2,7
"FDXR",1,3,0,1,1,1,7
"FLNA",0,1,2,1,2,1,7
"FOXE1",0,0,1,1,4,1,7
"FXYD3",2,2,0,0,3,0,7
"GARS",0,2,2,1,2,0,7
"GFI1",0,1,0,3,1,2,7
"GHRL",0,2,2,1,0,2,7
"GPBAR1",0,1,2,3,0,1,7
"HADHA",0,6,0,0,0,1,7
"HAND1",0,2,0,0,1,4,7
"HDAC8",0,5,0,1,0,1,7
"HES3",0,3,0,0,3,1,7
"HES6",0,2,0,1,3,1,7
"HIF1AN",0,3,0,2,1,1,7
"HLA-E",0,4,1,2,0,0,7
"HMGCR",0,2,1,3,1,0,7
"HRASLS",0,2,0,0,1,4,7
"HSD17B1",0,4,0,0,0,3,7
"IGFBP4",0,6,0,0,0,1,7
"IL4R",0,4,0,1,0,2,7
"IL7",0,2,0,0,3,2,7
"ING5",0,4,0,0,2,1,7
"INTS6",0,6,1,0,0,0,7
"ITGA2",0,5,0,0,1,1,7
"KDM4B",0,6,0,0,0,1,7
"KHDRBS1",1,3,0,2,1,0,7
"KIF2C",1,3,0,0,2,1,7
"KLF10",0,2,0,1,4,0,7
"KNG1",0,4,0,2,0,1,7
"LAMA4",0,1,0,3,1,2,7
"LAMP3",0,5,0,0,0,2,7
"LPO",0,2,2,1,1,1,7
"LTBR",1,4,0,2,0,0,7
"MAP4K4",0,3,1,1,2,0,7
"MBTPS1",1,4,0,1,1,0,7
"MFN2",1,1,0,4,0,1,7
"MIR20A",1,3,0,0,3,0,7
"MIR31",2,2,2,1,0,0,7
"MIR93",0,3,2,0,0,2,7
"MYCL",0,4,0,0,0,3,7
"MYEOV",0,2,2,0,0,3,7
"MZB1",0,1,0,2,4,0,7
"MZF1",0,2,0,2,1,2,7
"NCOR1",0,2,0,5,0,0,7
"NEAT1",1,2,1,1,1,1,7
"NEDD4L",1,2,0,1,2,1,7
"NEU3",0,7,0,0,0,0,7
"NQO2",1,1,1,3,0,1,7
"NRG1",0,2,1,1,3,0,7
"NRK",0,5,1,0,0,1,7
"NTRK3",0,3,0,0,3,1,7
"OGT",0,4,1,1,1,0,7
"ORAI1",0,2,2,3,0,0,7
"OSMR",0,3,0,1,1,2,7
"PDF",0,3,0,0,1,3,7
"PIGR",0,5,0,0,1,1,7
"PINX1",0,0,1,2,0,4,7
"PODXL",0,5,0,1,0,1,7
"POLB",0,3,1,0,2,1,7
"PPIA",1,3,0,0,3,0,7
"PRICKLE1",0,2,1,1,1,2,7
"PRKCZ",0,4,0,1,2,0,7
"PRLR",0,2,0,4,0,1,7
"PSMA7",0,5,0,1,1,0,7
"PSMB4",0,1,0,4,1,1,7
"PTGES",0,3,1,1,0,2,7
"PTN",0,1,2,1,2,1,7
"PTPN14",1,2,1,1,1,1,7
"RAB5A",0,0,0,6,0,1,7
"RASSF5",1,2,1,3,0,0,7
"RNASEL",2,4,0,0,1,0,7
"SCRN1",0,3,0,0,0,4,7
"SHE",0,2,4,0,0,1,7
"SIRT2",0,3,0,2,2,0,7
"SIRT3",0,1,0,5,0,1,7
"SLC10A1",2,0,2,3,0,0,7
"SLC2A2",0,1,0,4,2,0,7
"SLC2A3",1,4,0,2,0,0,7
"SLC2A4",0,1,0,2,3,1,7
"SNCG",0,5,1,1,0,0,7
"SPINT1",0,3,0,1,0,3,7
"SPRR3",0,2,4,1,0,0,7
"SREBF1",0,2,0,3,0,2,7
"SRSF3",0,4,0,3,0,0,7
"SSX2",0,3,1,3,0,0,7
"STYK1",1,4,0,1,0,1,7
"SUMO1",0,3,0,2,0,2,7
"TAGLN",0,4,0,1,0,2,7
"TEP1",0,2,0,0,2,3,7
"TMPRSS13",1,1,1,3,0,1,7
"TNFRSF10C",0,4,0,1,1,1,7
"TNFSF9",0,1,1,3,0,2,7
"TRPM7",0,0,1,1,4,1,7
"TXNRD1",0,5,0,1,1,0,7
"UGT1A10",1,4,0,2,0,0,7
"ULK1",0,3,1,2,1,0,7
"USP7",0,5,1,1,0,0,7
"VCP",0,2,1,3,0,1,7
"WASF2",0,1,0,3,0,3,7
"WWTR1",1,2,0,1,2,1,7
"XCL1",0,1,0,0,0,6,7
"XDH",0,2,0,3,0,2,7
"ABR",0,4,0,2,0,0,6
"ACACA",0,4,0,2,0,0,6
"ADAM23",0,1,0,0,1,4,6
"ADCY1",0,1,1,1,1,2,6
"ADCY10",0,3,0,0,1,2,6
"ADK",0,4,0,1,1,0,6
"ADRM1",0,4,0,0,0,2,6
"AGXT",0,4,0,1,0,1,6
"AHRR",1,2,0,2,1,0,6
"ANXA7",0,2,0,3,0,1,6
"APLP2",0,2,0,0,4,0,6
"AQP1",2,3,0,0,1,0,6
"ARAF",1,3,0,1,0,1,6
"ARHGAP35",0,3,0,2,0,1,6
"ARHGAP9",0,0,1,1,3,1,6
"ARID2",1,1,0,4,0,0,6
"ARRB1",0,2,1,1,0,2,6
"ARSA",0,0,6,0,0,0,6
"ARTN",0,1,0,0,5,0,6
"ATF5",0,0,1,5,0,0,6
"B4GALNT2",0,5,0,0,0,1,6
"BEST1",1,4,0,1,0,0,6
"BIRC7",1,2,0,0,0,3,6
"BLMH",0,1,1,2,1,1,6
"BMF",0,2,0,4,0,0,6
"BMI1",2,1,0,3,0,0,6
"BMP7",0,4,0,1,0,1,6
"BMPR2",0,6,0,0,0,0,6
"CAPZA1",0,1,2,1,0,2,6
"CASP3",0,1,1,2,0,2,6
"CAST",0,4,0,0,1,1,6
"CBX7",0,2,0,1,0,3,6
"CCL15",0,2,0,3,0,1,6
"CCNB2",1,3,0,1,0,1,6
"CDIPT",0,2,0,3,0,1,6
"CDR2",0,2,1,1,2,0,6
"CEBPB",0,4,0,1,0,1,6
"CELSR1",0,2,1,0,1,2,6
"CELSR2",0,2,1,0,1,2,6
"CELSR3",0,2,1,0,1,2,6
"CFH",0,2,0,3,1,0,6
"CHI3L1",0,3,0,1,1,1,6
"CNN1",0,3,1,1,0,1,6
"COL4A2",0,1,2,1,1,1,6
"CPA1",0,3,1,0,2,0,6
"CPQ",0,0,4,2,0,0,6
"CREBBP",0,4,1,0,1,0,6
"CSHL1",0,2,1,0,1,2,6
"CTBP1",0,3,0,2,0,1,6
"CTNNBIP1",0,3,0,1,0,2,6
"CXCL3",1,3,1,0,1,0,6
"CYP27A1",2,2,0,2,0,0,6
"DDC",0,1,1,1,0,3,6
"DIXDC1",0,4,0,1,0,1,6
"DLGAP5",0,2,0,4,0,0,6
"DSC3",0,2,1,2,0,1,6
"EDA",0,4,0,1,1,0,6
"EDN1",0,4,0,2,0,0,6
"EFNA4",0,2,1,1,1,1,6
"EFNA5",0,1,1,2,1,1,6
"FBN1",2,2,1,1,0,0,6
"FBN2",0,3,1,0,2,0,6
"FBP1",0,1,0,3,0,2,6
"FBXL20",0,3,0,1,1,1,6
"FCGBP",1,1,1,0,0,3,6
"FGF21",0,1,0,5,0,0,6
"FGF6",0,1,2,0,0,3,6
"FGF7",0,2,0,0,1,3,6
"FLT3",0,4,1,0,1,0,6
"FN1",1,1,1,3,0,0,6
"FOLH1",0,5,0,0,0,1,6
"FOXA3",0,1,0,2,1,2,6
"FPR1",0,2,0,1,0,3,6
"FRS2",1,1,0,1,0,3,6
"FUBP1",0,2,0,3,0,1,6
"G3BP1",0,3,0,0,2,1,6
"G6PD",1,3,0,2,0,0,6
"GABARAP",0,2,0,4,0,0,6
"GMDS",0,4,0,2,0,0,6
"GSTA2",0,4,0,1,0,1,6
"GSTO2",1,2,0,2,0,1,6
"HECA",0,4,0,0,1,1,6
"HES4",0,2,0,0,3,1,6
"HFE2",1,2,0,3,0,0,6
"HLA-DRB1",0,2,0,2,1,1,6
"HOXB13",0,6,0,0,0,0,6
"HOXB9",0,2,1,1,0,2,6
"HPX",1,3,0,2,0,0,6
"HTATIP2",1,0,1,2,1,1,6
"IDE",0,1,0,5,0,0,6
"IGF2BP1",0,3,0,2,0,1,6
"IL13",0,4,1,0,1,0,6
"IL3",0,1,0,2,1,2,6
"INA",1,3,0,1,1,0,6
"INCENP",0,3,1,1,1,0,6
"ISG15",0,2,1,3,0,0,6
"ISX",0,3,0,1,0,2,6
"ITGA6",0,4,0,1,1,0,6
"ITGB3",0,1,0,2,2,1,6
"IVD",0,6,0,0,0,0,6
"KCNH2",0,5,0,0,0,1,6
"KIF1B",0,0,0,5,0,1,6
"KLF2",0,0,0,3,0,3,6
"LDHA",0,4,0,2,0,0,6
"LDHB",2,2,0,2,0,0,6
"LRP1B",1,0,2,2,0,1,6
"LTB",1,2,0,0,3,0,6
"LYPD3",0,2,2,0,2,0,6
"MAGI3",0,2,1,1,0,2,6
"MAP3K11",0,3,1,0,0,2,6
"MASP2",0,3,1,2,0,0,6
"MBD1",0,5,0,0,1,0,6
"MIR126",0,3,0,1,1,1,6
"MIR222",0,0,0,3,1,2,6
"MIR335",1,3,0,0,0,2,6
"MOB1A",1,0,1,2,1,1,6
"MTUS1",0,3,1,1,0,1,6
"MUC17",0,4,0,0,2,0,6
"MUS81",0,3,0,2,0,1,6
"NDN",0,2,2,0,1,1,6
"NFATC1",0,3,0,1,2,0,6
"NLK",0,1,0,2,3,0,6
"NNT",0,3,2,0,0,1,6
"NOS1",1,2,2,0,1,0,6
"NOXO1",0,4,1,0,0,1,6
"NPRL2",0,2,1,2,0,1,6
"NRG4",0,2,1,1,0,2,6
"ORAOV1",0,0,4,1,0,1,6
"P2RX7",0,2,1,0,2,1,6
"PARG",0,4,0,1,1,0,6
"PCSK7",0,0,0,4,2,0,6
"PDGFA",0,2,0,1,2,1,6
"PDIA3",2,2,0,1,0,1,6
"PIAS1",0,3,0,2,0,1,6
"PIK3C3",0,2,2,0,1,1,6
"PLAGL2",1,1,1,0,1,2,6
"PLD1",0,3,0,0,0,3,6
"PLK2",1,2,0,2,1,0,6
"PNMT",1,0,0,1,1,3,6
"POLD1",0,5,0,1,0,0,6
"POU2F2",0,1,0,0,3,2,6
"PPFIA1",0,1,3,1,0,1,6
"PRDM1",0,1,1,0,2,2,6
"PRDX2",0,1,3,0,2,0,6
"PRICKLE2",0,2,1,0,1,2,6
"PROK1",0,2,0,2,1,1,6
"PSEN1",0,4,1,0,1,0,6
"PSMA6",0,2,1,1,0,2,6
"PTK2B",0,2,0,3,1,0,6
"PTPN1",0,3,0,2,1,0,6
"PUF60",0,4,1,0,0,1,6
"PVRL2",0,2,0,3,0,1,6
"PYGB",0,3,0,0,0,3,6
"RASAL1",0,4,0,2,0,0,6
"RBL2",0,2,1,2,0,1,6
"RGS19",0,1,0,0,2,3,6
"RP1",0,3,1,0,1,1,6
"RPS6KA2",0,4,0,1,1,0,6
"RREB1",0,1,0,0,5,0,6
"RRM2B",0,4,1,1,0,0,6
"RSPO1",0,6,0,0,0,0,6
"SATB2",0,6,0,0,0,0,6
"SDHA",2,3,0,1,0,0,6
"SELPLG",0,5,0,0,0,1,6
"SEMA3F",0,4,0,1,1,0,6
"SERPINB3",1,0,0,5,0,0,6
"SERPINF2",0,0,0,4,0,2,6
"SERPINH1",2,2,0,0,0,2,6
"SHBG",1,3,1,0,0,1,6
"SHOC2",0,3,0,3,0,0,6
"SLC10A2",1,5,0,0,0,0,6
"SLC11A2",0,3,0,3,0,0,6
"SLC15A1",1,2,0,1,1,1,6
"SLC22A7",0,2,0,4,0,0,6
"SLC39A4",0,0,0,1,5,0,6
"SLCO2B1",0,1,0,3,1,1,6
"SLIT2",0,5,0,0,0,1,6
"SNCA",1,5,0,0,0,0,6
"SOX18",0,1,1,0,2,2,6
"SPINT2",0,1,0,2,0,3,6
"SRI",0,3,0,0,0,3,6
"SSTR5",1,1,1,1,2,0,6
"ST13",0,6,0,0,0,0,6
"TCFL5",0,5,0,0,0,1,6
"TFDP1",1,2,0,3,0,0,6
"TFDP3",0,1,0,5,0,0,6
"TGFB2",0,3,0,2,1,0,6
"TGM2",0,1,0,1,3,1,6
"THY1",1,1,0,2,0,2,6
"TJP2",0,2,0,0,3,1,6
"TK1",1,1,0,1,1,2,6
"TLN1",0,2,0,3,0,1,6
"TMEM132D",1,4,0,1,0,0,6
"TOB1",0,2,0,1,1,2,6
"TOMM34",0,6,0,0,0,0,6
"TP63",0,0,4,1,1,0,6
"TRAF1",0,3,0,2,0,1,6
"TRAP1",0,5,0,0,1,0,6
"TTK",0,2,1,1,1,1,6
"TTR",0,0,1,3,1,1,6
"TUSC1",0,2,0,1,1,2,6
"TXNDC5",0,1,1,2,0,2,6
"TXNL1",0,2,0,1,0,3,6
"VASH1",0,1,0,3,2,0,6
"VSIG1",0,1,2,0,0,3,6
"WISP2",1,1,0,3,1,0,6
"WNT1",0,1,1,1,0,3,6
"ZBTB20",0,0,1,2,0,3,6
"ZIC1",0,3,0,0,0,3,6
"ABCG8",4,1,0,0,0,0,5
"ACD",1,4,0,0,0,0,5
"ADAM15",0,1,0,0,2,2,5
"ADAMTS18",0,3,0,0,1,1,5
"AFAP1L2",0,1,1,0,0,3,5
"AKR1C3",0,3,0,1,0,1,5
"AMFR",0,1,0,1,0,3,5
"ANKRD6",0,1,1,0,1,2,5
"ANTXR1",1,3,0,1,0,0,5
"ANXA3",1,1,0,2,0,1,5
"APOA1",1,1,0,2,0,1,5
"APOM",0,2,0,3,0,0,5
"APRT",0,4,0,0,1,0,5
"ARHGEF28",0,3,0,0,2,0,5
"ASAP1",0,2,0,2,0,1,5
"ATRX",0,0,0,1,4,0,5
"BICC1",2,0,0,2,0,1,5
"BIN1",0,2,1,2,0,0,5
"BMP1",0,3,1,0,0,1,5
"BMX",1,1,0,0,1,2,5
"C1R",0,2,0,0,1,2,5
"C21orf2",0,3,0,1,1,0,5
"CA12",0,2,0,2,0,1,5
"CADM3",0,3,1,0,0,1,5
"CARTPT",1,1,1,1,0,1,5
"CASP10",0,2,1,1,0,1,5
"CASP9",0,4,0,0,0,1,5
"CASQ2",0,0,0,0,2,3,5
"CAV2",1,2,1,0,0,1,5
"CCKAR",3,0,0,0,2,0,5
"CCL13",0,1,0,4,0,0,5
"CCL25",0,1,0,0,3,1,5
"CCL28",0,3,1,0,1,0,5
"CD164",0,2,0,0,0,3,5
"CD200",0,4,1,0,0,0,5
"CD226",0,5,0,0,0,0,5
"CD3G",0,3,0,2,0,0,5
"CEMIP",0,4,0,1,0,0,5
"CHD5",1,2,0,0,0,2,5
"CIITA",0,2,0,2,1,0,5
"CLDN5",0,0,0,1,2,2,5
"CLEC4D",1,2,0,1,0,1,5
"COL6A3",0,1,0,1,1,2,5
"CSNK1A1",0,4,1,0,0,0,5
"CST3",0,2,0,2,0,1,5
"CTNND1",0,4,0,0,1,0,5
"CX3CR1",1,2,0,1,0,1,5
"CXCR5",0,2,0,2,1,0,5
"CXXC1",2,1,0,1,0,1,5
"DAB2IP",0,0,0,3,1,1,5
"DAXX",0,0,0,2,3,0,5
"DDIT4",0,4,0,1,0,0,5
"DDX3X",0,0,0,5,0,0,5
"DEFA5",0,5,0,0,0,0,5
"DEPTOR",0,0,0,5,0,0,5
"DFNA5",0,3,0,1,0,1,5
"DGCR8",0,1,1,2,1,0,5
"DHDDS",1,0,1,2,0,1,5
"DIAPH1",0,1,0,0,3,1,5
"DIAPH2",0,0,1,0,3,1,5
"DLX4",0,3,0,2,0,0,5
"DMD",0,2,1,1,0,1,5
"DSCAM",0,5,0,0,0,0,5
"DSPP",0,2,0,0,1,2,5
"DTL",0,3,0,2,0,0,5
"DUSP4",0,5,0,0,0,0,5
"ECT2",0,1,1,2,1,0,5
"EDIL3",0,4,0,1,0,0,5
"EDNRB",0,2,0,2,1,0,5
"EEF1A2",1,0,0,1,2,1,5
"EN1",0,4,0,0,0,1,5
"EOMES",0,3,1,0,0,1,5
"ERBB2IP",2,2,0,1,0,0,5
"EYA4",1,3,1,0,0,0,5
"F9",0,1,1,2,0,1,5
"FADS1",0,0,1,3,0,1,5
"FBL",0,0,0,3,1,1,5
"FGF20",0,4,0,0,1,0,5
"FGF23",0,2,0,1,1,1,5
"FHL1",0,1,1,0,0,3,5
"FLNB",0,0,1,2,1,1,5
"FLT4",1,2,0,0,0,2,5
"FMNL1",0,1,0,0,3,1,5
"FRK",0,1,1,1,0,2,5
"FUS",0,1,0,2,0,2,5
"FUT5",0,2,0,0,1,2,5
"GALNT12",0,5,0,0,0,0,5
"GCK",0,2,0,2,1,0,5
"GH2",0,1,0,0,2,2,5
"GHSR",0,2,1,0,0,2,5
"GLO1",0,2,0,0,1,2,5
"GLP1R",0,2,0,0,2,1,5
"GML",0,1,4,0,0,0,5
"GNA12",0,0,0,2,2,1,5
"GNL3",1,2,1,0,0,1,5
"GP5",0,1,4,0,0,0,5
"GRHL1",0,3,1,1,0,0,5
"GSK3A",0,1,0,1,2,1,5
"GSN",0,2,2,0,0,1,5
"GSS",1,1,0,1,2,0,5
"HACE1",0,2,0,1,0,2,5
"HCK",0,1,0,0,0,4,5
"HDAC7",0,1,0,2,1,1,5
"HMGB3",0,2,0,0,1,2,5
"HNRNPK",0,3,0,1,0,1,5
"HOXA1",2,0,1,1,0,1,5
"HOXA5",1,1,1,0,2,0,5
"HSPA1B",0,1,0,3,1,0,5
"HTRA1",0,1,1,1,0,2,5
"HULC",0,0,0,5,0,0,5
"IAPP",0,0,0,0,5,0,5
"ICK",0,4,0,0,0,1,5
"ID3",0,1,0,3,1,0,5
"IFNGR2",0,2,0,1,1,1,5
"IGF2BP2",0,1,1,3,0,0,5
"INHBA",0,1,0,0,0,4,5
"IRAK1",0,1,0,2,0,2,5
"IRF7",0,1,1,1,1,1,5
"IRX1",0,0,0,0,0,5,5
"ITGA9",0,3,0,2,0,0,5
"JUP",0,4,0,0,1,0,5
"KAT2B",0,1,1,1,0,2,5
"KCNA3",0,4,0,1,0,0,5
"KDM4C",0,2,2,0,0,1,5
"KIN",0,3,1,0,1,0,5
"KISS1R",0,0,2,0,1,2,5
"KITLG",0,4,0,0,0,1,5
"KLF11",0,0,0,2,3,0,5
"KLK11",0,2,0,0,1,2,5
"KRT13",1,1,0,2,1,0,5
"KRT14",0,2,1,0,1,1,5
"LGALS9",0,3,0,1,0,1,5
"LGR6",0,3,0,0,0,2,5
"LIMS1",0,3,0,2,0,0,5
"LIPA",0,0,0,3,0,2,5
"LPCAT1",0,2,1,2,0,0,5
"MAGEA3",0,2,0,0,2,1,5
"MAP3K10",0,2,0,0,1,2,5
"MAPK6",1,0,0,1,3,0,5
"MAPK7",0,3,0,1,0,1,5
"MAT2B",0,2,0,3,0,0,5
"MCAM",1,1,1,1,0,1,5
"MCAT",0,2,0,1,1,1,5
"MCM3AP",2,1,0,2,0,0,5
"MED12",0,4,0,0,0,1,5
"MELK",0,4,0,0,1,0,5
"MFRP",0,2,0,0,0,3,5
"MIA",0,0,1,2,1,1,5
"MIR26B",0,4,0,1,0,0,5
"MIR34B",0,3,0,0,1,1,5
"MIR499A",0,1,0,2,0,2,5
"MMP16",0,2,1,1,1,0,5
"MMP28",1,2,0,0,1,1,5
"MORF4",0,2,0,0,2,1,5
"MSX2",1,0,0,0,3,1,5
"MT-CO1",0,3,0,2,0,0,5
"MT1H",0,1,0,3,1,0,5
"MT1X",0,3,0,1,0,1,5
"MTNR1B",0,1,1,0,2,1,5
"MTR",0,2,0,3,0,0,5
"MYH11",0,5,0,0,0,0,5
"MYH9",0,3,1,0,0,1,5
"NCOR2",0,0,1,4,0,0,5
"NCSTN",0,2,1,1,0,1,5
"NEIL2",0,4,0,1,0,0,5
"NEK6",0,0,0,3,1,1,5
"NELL2",0,4,0,0,0,1,5
"NFAT5",0,4,1,0,0,0,5
"NGF",1,0,1,1,2,0,5
"NOG",0,3,1,0,0,1,5
"NOL3",0,4,0,1,0,0,5
"NOXA1",0,5,0,0,0,0,5
"NPAT",0,4,1,0,0,0,5
"NTRK1",1,1,0,1,2,0,5
"PAPSS1",1,3,0,1,0,0,5
"PCSK6",1,3,0,1,0,0,5
"PDGFB",1,1,1,0,1,1,5
"PIWIL1",0,2,1,1,0,1,5
"PIWIL2",1,3,0,0,0,1,5
"PLA2G1B",0,2,0,2,1,0,5
"PLA2G6",0,3,0,2,0,0,5
"PLCG1",0,3,0,1,0,1,5
"PMS2CL",0,3,0,0,0,2,5
"PPP1CC",0,4,0,0,0,1,5
"PPP2R1A",0,2,0,1,1,1,5
"PRMT1",0,2,1,2,0,0,5
"PROCR",0,0,0,2,0,3,5
"PRUNE",0,2,0,0,0,3,5
"PSMD1",0,1,1,2,1,0,5
"PTAFR",0,2,1,0,0,2,5
"PTF1A",0,0,0,0,5,0,5
"PTGER3",0,3,0,1,0,1,5
"PTK6",0,4,0,1,0,0,5
"PYY",0,0,1,0,4,0,5
"RAD17",0,4,0,0,1,0,5
"RALBP1",0,2,0,0,3,0,5
"RAP1B",0,3,0,0,2,0,5
"RAP1GAP",0,3,0,0,2,0,5
"RARB",0,2,1,0,0,2,5
"RARRES1",1,2,0,0,0,2,5
"RBM3",0,5,0,0,0,0,5
"RBPMS",0,5,0,0,0,0,5
"RELN",0,0,0,2,1,2,5
"RIN1",0,3,0,0,0,2,5
"ROBO2",2,3,0,0,0,0,5
"RORA",0,1,0,0,0,4,5
"S1PR2",3,1,1,0,0,0,5
"SEMA5A",0,1,0,0,2,2,5
"SEMA6A",0,2,0,2,0,1,5
"SEPP1",1,2,1,1,0,0,5
"SERPINA4",0,2,1,2,0,0,5
"SIAH1",0,2,1,2,0,0,5
"SLC1A2",0,0,0,4,0,1,5
"SLC22A2",0,1,1,2,1,0,5
"SLC25A13",0,0,0,5,0,0,5
"SLC39A6",0,0,2,2,1,0,5
"SLC52A3",0,0,3,0,0,2,5
"SMAD5",0,1,0,2,0,2,5
"SMOX",0,3,0,0,0,2,5
"SNAI3",0,2,0,1,0,2,5
"SOX10",0,2,1,1,1,0,5
"SOX6",0,0,2,3,0,0,5
"SPG20",1,3,1,0,0,0,5
"SPOCK1",1,0,1,2,0,1,5
"SPRY4",0,2,0,1,1,1,5
"SSB",0,1,0,3,0,1,5
"ST3GAL1",0,4,0,0,0,1,5
"ST6GALNAC1",0,1,0,1,0,3,5
"STAG2",0,2,0,0,1,2,5
"TBX2",0,0,0,0,5,0,5
"TBXA2R",0,3,0,0,0,2,5
"TCF12",0,4,0,1,0,0,5
"TEAD1",0,1,0,0,3,1,5
"TEAD4",0,1,0,2,1,1,5
"TEF",1,0,3,1,0,0,5
"TFCP2",0,1,0,3,0,1,5
"TGFB1I1",0,3,0,2,0,0,5
"THBD",0,2,1,0,1,1,5
"THRA",0,1,0,4,0,0,5
"TLE1",0,2,1,2,0,0,5
"TLR1",0,2,1,0,0,2,5
"TNFSF15",0,2,0,2,1,0,5
"TRADD",0,0,1,1,1,2,5
"TRIM24",0,0,0,5,0,0,5
"TRIM28",0,3,0,1,0,1,5
"TRIM29",0,1,0,0,2,2,5
"TRIT1",2,0,0,1,1,1,5
"TRPC1",0,1,1,1,2,0,5
"TSG101",1,2,0,2,0,0,5
"USF1",0,3,0,1,0,1,5
"USP10",0,2,1,0,0,2,5
"VIPR1",0,4,0,0,0,1,5
"VMP1",0,1,0,2,2,0,5
"WDR11",0,0,0,1,0,4,5
"WRN",0,2,1,1,0,1,5
"ZBTB16",0,5,0,0,0,0,5
"ZFX",1,0,1,1,0,2,5
"ZNF160",1,1,0,2,0,1,5
"ZNF331",1,1,1,0,0,2,5
"A1BG",0,1,0,1,1,1,4
"A4GNT",0,0,0,0,0,4,4
"ABCA2",0,2,0,2,0,0,4
"ABCC11",1,1,0,1,0,1,4
"ACHE",0,1,1,1,0,1,4
"ACLY",0,3,0,1,0,0,4
"ACPP",0,0,1,1,2,0,4
"ADAM28",0,3,0,1,0,0,4
"ADCYAP1",0,4,0,0,0,0,4
"ADH5",0,0,0,3,1,0,4
"ADH7",0,1,1,0,1,1,4
"AFAP1-AS1",1,1,1,1,0,0,4
"AGO1",0,2,0,1,0,1,4
"AJUBA",0,1,2,0,0,1,4
"AKR7A3",0,0,0,4,0,0,4
"ALDH1A3",0,2,1,0,0,1,4
"ALPL",0,1,0,1,1,1,4
"ANAPC1",0,3,0,0,0,1,4
"ANGPTL2",0,1,1,1,0,1,4
"APOC1",0,1,0,0,1,2,4
"ARF1",0,1,0,2,0,1,4
"ARFIP2",0,1,0,0,0,3,4
"ARHGAP1",0,2,0,1,1,0,4
"ASL",0,0,0,3,0,1,4
"ASS1",0,0,0,2,1,1,4
"ATG12",0,1,1,1,0,1,4
"ATP8B1",1,0,0,3,0,0,4
"AZGP1",0,1,0,1,2,0,4
"AZIN1",0,0,1,3,0,0,4
"B3GALT5",0,2,0,0,2,0,4
"B4GALNT1",0,2,0,2,0,0,4
"BHLHE40",0,1,0,0,2,1,4
"BHMT",0,0,0,4,0,0,4
"BMP3",1,2,0,0,0,1,4
"BMP6",0,1,1,1,0,1,4
"BMPR1B",0,4,0,0,0,0,4
"BPI",0,2,1,1,0,0,4
"BRD7",0,3,0,0,0,1,4
"BRE",0,1,3,0,0,0,4
"BTF3",0,2,0,0,1,1,4
"BUB3",0,2,0,0,0,2,4
"BVES",0,1,0,1,0,2,4
"CACNA1A",0,1,0,0,1,2,4
"CAMP",1,2,0,0,1,0,4
"CAPN1",1,0,1,1,0,1,4
"CAPN2",0,1,0,2,0,1,4
"CAPNS1",1,0,0,3,0,0,4
"CARD10",0,0,0,1,1,2,4
"CASK",0,1,1,1,0,1,4
"CBX5",0,2,0,0,1,1,4
"CCDC6",1,1,0,0,0,2,4
"CCDC88A",0,1,0,3,0,0,4
"CCNH",1,1,0,1,0,1,4
"CD1D",0,1,0,3,0,0,4
"CD3E",0,4,0,0,0,0,4
"CD70",0,1,0,1,1,1,4
"CDC16",0,2,0,1,0,1,4
"CDH11",0,2,0,0,0,2,4
"CDH22",0,4,0,0,0,0,4
"CDKN2D",0,1,0,1,1,1,4
"CDT1",0,2,0,0,1,1,4
"CEBPD",0,2,0,2,0,0,4
"CELA1",0,0,0,0,4,0,4
"CES2",2,2,0,0,0,0,4
"CHD3",0,1,0,1,1,1,4
"CHD4",0,2,0,0,1,1,4
"CHD7",0,2,0,0,1,1,4
"CHD8",0,2,0,0,0,2,4
"CHKA",0,1,0,3,0,0,4
"CLDN23",0,1,0,0,1,2,4
"CLDN24",0,2,0,0,0,2,4
"CNPY2",0,0,0,2,1,1,4
"CNR1",0,3,1,0,0,0,4
"CNTN6",0,2,0,1,0,1,4
"COG8",0,1,1,1,0,1,4
"COL12A1",0,4,0,0,0,0,4
"COL4A5",0,1,2,0,0,1,4
"COL4A6",0,1,2,0,0,1,4
"CORO1C",0,0,0,3,0,1,4
"CPS1",2,1,0,0,0,1,4
"CRHR2",0,1,0,3,0,0,4
"CRY1",0,3,0,1,0,0,4
"CSTB",1,1,2,0,0,0,4
"CTF1",0,1,0,0,1,2,4
"CTH",0,1,0,2,1,0,4
"CTSZ",1,0,0,1,0,2,4
"CUL1",0,3,1,0,0,0,4
"CUL2",0,1,1,1,0,1,4
"CXCL13",0,2,0,1,1,0,4
"CXCL5",0,2,0,0,0,2,4
"CXXC4",0,1,0,1,0,2,4
"CYP2C8",0,3,0,0,1,0,4
"CYSLTR1",0,3,1,0,0,0,4
"DDB1",0,0,0,3,1,0,4
"DDR2",0,3,0,1,0,0,4
"DDX58",0,0,0,3,1,0,4
"DEDD",1,1,1,1,0,0,4
"DHCR7",0,3,0,1,0,0,4
"DIAPH3",0,0,0,2,2,0,4
"DIO3",0,0,0,4,0,0,4
"DST",0,0,0,1,2,1,4
"DZIP1L",0,1,1,0,1,1,4
"EEA1",0,1,0,2,1,0,4
"EFNB3",0,1,1,0,1,1,4
"EGFL8",0,2,0,1,0,1,4
"EGR3",0,2,0,0,1,1,4
"EIF3I",0,2,0,2,0,0,4
"EIF6",0,3,0,0,0,1,4
"ELAVL3",1,0,0,2,1,0,4
"ENOX2",0,1,0,1,0,2,4
"ERCC3",0,3,0,1,0,0,4
"ERCC5",0,3,0,0,0,1,4
"EVL",0,2,1,0,0,1,4
"F8",0,1,0,3,0,0,4
"FADS2",0,0,0,3,1,0,4
"FAM84A",0,3,0,1,0,0,4
"FAM84B",0,0,3,0,1,0,4
"FBXO32",0,1,1,0,0,2,4
"FDX1",0,2,0,2,0,0,4
"FGF9",0,2,0,1,0,1,4
"FGR",0,2,0,2,0,0,4
"FLII",0,2,0,1,1,0,4
"FMNL3",0,0,0,0,3,1,4
"FNDC3B",0,0,1,3,0,0,4
"FOXC1",0,0,1,2,1,0,4
"FOXD3",0,1,0,0,1,2,4
"FOXH1",0,0,1,0,2,1,4
"FSD1",0,0,1,0,0,3,4
"FTL",0,1,0,2,0,1,4
"FTO",0,1,0,2,1,0,4
"FUT8",0,1,0,3,0,0,4
"G3BP2",0,1,0,0,2,1,4
"GABARAPL2",0,2,0,1,1,0,4
"GALNT14",0,1,1,2,0,0,4
"GATA5",0,1,1,0,0,2,4
"GDA",0,0,0,3,0,1,4
"GJC1",0,4,0,0,0,0,4
"GNAQ",0,4,0,0,0,0,4
"GNE",1,0,0,1,2,0,4
"GPS1",0,0,4,0,0,0,4
"GRB7",0,0,1,0,0,3,4
"GRHL2",0,0,1,1,0,2,4
"GSPT1",0,0,0,1,0,3,4
"GSTA4",0,0,0,3,1,0,4
"HDGF",1,1,0,2,0,0,4
"HHAT",1,0,0,0,1,2,4
"HLA-DOA",0,3,0,1,0,0,4
"HMGCS2",0,3,1,0,0,0,4
"HNRNPA1",0,2,0,1,1,0,4
"HNRNPD",0,0,1,3,0,0,4
"HNRNPH1",0,2,0,1,0,1,4
"HOOK2",0,2,1,0,0,1,4
"HOPX",0,1,0,0,1,2,4
"HOXA13",0,0,2,1,0,1,4
"HOXA9",1,1,2,0,0,0,4
"HOXC6",0,0,3,0,0,1,4
"HOXD13",1,0,1,0,1,1,4
"HPR",0,0,0,1,1,2,4
"HRG",0,1,0,0,2,1,4
"HRH4",1,2,0,0,0,1,4
"HS3ST2",0,2,0,0,1,1,4
"HSD17B2",0,2,0,1,0,1,4
"HSD17B7",1,1,0,2,0,0,4
"HSP90AA1",0,1,0,2,0,1,4
"HSPG2",0,1,0,0,2,1,4
"HUS1",0,2,1,0,0,1,4
"IDO2",0,1,0,0,3,0,4
"IFNA21",0,0,0,4,0,0,4
"IFT88",1,0,0,3,0,0,4
"IGLL1",0,0,0,2,1,1,4
"IKBKE",0,2,0,1,1,0,4
"IL16",0,2,0,1,0,1,4
"IL1RL1",0,0,0,2,0,2,4
"IL31RA",0,1,0,1,0,2,4
"IL7R",0,1,1,1,0,1,4
"IMPDH2",0,3,0,0,0,1,4
"ING3",0,0,1,2,1,0,4
"INPPL1",0,2,0,2,0,0,4
"IRF5",0,1,0,2,0,1,4
"IRF9",0,0,0,2,1,1,4
"ITGB6",0,3,0,0,1,0,4
"IVL",0,0,4,0,0,0,4
"KAT2A",0,1,1,1,0,1,4
"KCNK17",0,1,0,1,1,1,4
"KCNN4",0,2,0,1,1,0,4
"KIF14",0,1,0,2,1,0,4
"KIFC1",0,1,0,2,0,1,4
"KLF12",0,2,0,0,0,2,4
"KLF17",0,0,1,2,0,1,4
"KLK14",0,4,0,0,0,0,4
"KMT2C",0,0,0,1,2,1,4
"KRT9",0,0,0,1,1,2,4
"LAMB1",0,2,0,2,0,0,4
"LECT2",0,0,0,4,0,0,4
"LGALS8",0,3,1,0,0,0,4
"LGMN",0,1,1,0,0,2,4
"LHB",1,0,0,3,0,0,4
"LIFR",0,1,1,2,0,0,4
"LILRB2",0,0,1,1,1,1,4
"LIPH",0,2,0,2,0,0,4
"LRIG1",0,4,0,0,0,0,4
"LTB4R",0,0,1,0,2,1,4
"LY6K",0,0,3,0,0,1,4
"MAD1L1",0,0,1,1,0,2,4
"MAD2L1",0,3,0,1,0,0,4
"MAGEA4",0,0,3,0,0,1,4
"MAGI1",0,2,0,2,0,0,4
"MAP3K2",0,2,0,2,0,0,4
"MAP3K9",0,3,1,0,0,0,4
"MAP4K3",0,1,0,1,2,0,4
"MCRS1",0,2,1,1,0,0,4
"MEF2C",0,2,0,1,0,1,4
"MEF2D",0,0,1,2,1,0,4
"MFAP3L",0,3,0,1,0,0,4
"MIA2",0,0,1,3,0,0,4
"MIR106B",0,0,0,1,0,3,4
"MIR10B",0,1,1,0,1,1,4
"MIR135B",0,4,0,0,0,0,4
"MIR200B",1,1,0,1,0,1,4
"MIR23A",0,1,0,2,1,0,4
"MIR302B",0,1,1,2,0,0,4
"MLANA",0,3,0,0,1,0,4
"MNX1",0,0,1,1,1,1,4
"MSH5",0,4,0,0,0,0,4
"MSX1",0,3,0,0,0,1,4
"MT1E",0,1,0,2,1,0,4
"MTHFD1",0,4,0,0,0,0,4
"MTNR1A",0,1,1,0,1,1,4
"MX1",0,1,0,3,0,0,4
"MXI1",0,0,2,0,0,2,4
"NCF1",0,3,1,0,0,0,4
"NDST1",0,2,0,1,0,1,4
"NDUFA13",0,1,0,2,0,1,4
"NEDD8",1,2,0,1,0,0,4
"NEU1",0,3,0,0,1,0,4
"NEUROG3",0,2,0,0,2,0,4
"NID1",1,1,0,1,0,1,4
"NKX2-5",0,2,1,1,0,0,4
"NLRP12",0,4,0,0,0,0,4
"NMT1",0,3,0,0,0,1,4
"NRD1",0,0,2,1,0,1,4
"NTHL1",1,2,0,0,0,1,4
"NTN1",0,4,0,0,0,0,4
"NUCB2",0,1,0,0,0,3,4
"NUF2",0,1,0,1,0,2,4
"OIP5",0,1,1,0,0,2,4
"OMP",1,0,0,0,0,3,4
"OPCML",2,0,0,1,0,1,4
"OSR2",0,0,1,0,1,2,4
"P2RY2",0,3,0,1,0,0,4
"PAK2",0,0,0,2,0,2,4
"PAX4",0,1,1,1,0,1,4
"PBLD",0,0,0,2,0,2,4
"PBX1",0,1,1,0,2,0,4
"PCBP1",1,1,0,1,1,0,4
"PDCD1LG2",0,0,0,3,0,1,4
"PDCD6IP",0,2,0,2,0,0,4
"PDGFRL",0,2,1,1,0,0,4
"PF4",0,1,1,0,2,0,4
"PGAM1",1,2,0,1,0,0,4
"PHF20",0,2,0,2,0,0,4
"PIAS4",0,1,0,1,1,1,4
"PIGF",0,2,0,2,0,0,4
"PIK3CG",0,3,0,0,1,0,4
"PITX1",0,2,0,1,0,1,4
"PKHD1",1,1,0,1,1,0,4
"PLA2G4A",0,2,0,1,0,1,4
"PLA2G7",0,1,1,1,0,1,4
"PLAC1",0,2,0,0,0,2,4
"PLAGL1",0,1,0,1,0,2,4
"PLCG2",0,3,0,0,0,1,4
"PLSCR1",0,3,0,1,0,0,4
"PNLIP",1,0,0,1,2,0,4
"POLR2A",0,2,0,1,0,1,4
"PON1",0,3,0,0,1,0,4
"PPBP",0,1,1,1,0,1,4
"PPIB",0,1,0,1,2,0,4
"PPP1R12A",0,1,0,3,0,0,4
"PPP1R13L",0,1,0,2,0,1,4
"PPP1R15A",0,2,0,1,1,0,4
"PPP2R2A",1,0,1,1,1,0,4
"PPP3CA",0,1,1,1,1,0,4
"PPY",0,0,0,1,2,1,4
"PRDM5",0,2,0,0,0,2,4
"PRKAA1",0,2,0,0,0,2,4
"PRKCA",0,0,0,0,1,3,4
"PRKCB",0,2,0,0,2,0,4
"PTGR1",0,2,0,1,1,0,4
"PVT1",0,2,0,1,1,0,4
"RAC2",0,1,0,1,0,2,4
"RAD23B",1,0,1,2,0,0,4
"RAD51D",0,3,0,0,0,1,4
"RAD54B",0,2,1,0,0,1,4
"RAD54L",0,1,0,0,3,0,4
"RAG1",0,3,0,1,0,0,4
"RAMP3",0,2,0,0,1,1,4
"RASAL2",0,1,0,1,0,2,4
"RASSF10",0,0,1,0,1,2,4
"RBBP6",0,3,1,0,0,0,4
"RBM38",0,3,1,0,0,0,4
"RECQL",0,1,0,0,3,0,4
"RETN",0,3,0,0,1,0,4
"RFC1",0,2,1,0,0,1,4
"RNF26",0,2,0,0,0,2,4
"RP9",0,1,0,2,1,0,4
"RPA1",0,1,3,0,0,0,4
"RPA2",0,2,1,1,0,0,4
"RPL37",0,1,0,2,0,1,4
"RPL6",0,1,1,0,0,2,4
"RPS27A",0,3,0,0,0,1,4
"RPS6KA3",0,0,2,2,0,0,4
"RPSA",0,3,0,1,0,0,4
"RRH",0,1,1,0,1,1,4
"RTEL1",0,1,0,2,1,0,4
"S100A1",0,1,0,0,0,3,4
"S100A14",0,2,1,1,0,0,4
"SALL3",0,1,0,2,1,0,4
"SASH1",0,4,0,0,0,0,4
"SCEL",0,1,1,1,0,1,4
"SEMA4C",0,1,1,0,1,1,4
"SEPT4",0,4,0,0,0,0,4
"SERPINB2",2,0,0,0,1,1,4
"SFPQ",0,4,0,0,0,0,4
"SGO1",0,3,0,0,0,1,4
"SLC23A2",0,1,1,0,0,2,4
"SLC28A1",0,0,0,2,2,0,4
"SLC31A1",0,3,0,1,0,0,4
"SLC9A1",0,4,0,0,0,0,4
"SLCO2A1",0,2,0,1,1,0,4
"SND1",0,3,0,0,0,1,4
"SOCS5",0,2,0,2,0,0,4
"SOD3",1,0,0,1,2,0,4
"SPANXC",0,1,0,3,0,0,4
"SPRR2A",2,0,1,0,0,1,4
"SPRY2",0,2,0,1,1,0,4
"SRD5A2",0,0,0,4,0,0,4
"SRGN",1,1,0,2,0,0,4
"SRPX2",0,1,0,0,1,2,4
"ST3GAL4",0,1,0,0,1,2,4
"ST7L",0,0,1,0,0,3,4
"STARD3",0,0,1,0,0,3,4
"STK24",0,1,0,1,2,0,4
"STK31",0,3,1,0,0,0,4
"STMN2",0,0,0,3,0,1,4
"STRA13",0,1,1,0,2,0,4
"STX1A",0,3,0,0,1,0,4
"SULT2B1",0,2,1,1,0,0,4
"TBX5",0,2,0,1,0,1,4
"TCERG1L",0,3,0,0,0,1,4
"TCF21",0,2,2,0,0,0,4
"TCP1",0,3,0,1,0,0,4
"TET1",0,0,0,2,0,2,4
"TET2",0,1,2,1,0,0,4
"TFE3",0,1,1,1,0,1,4
"TFG",0,2,1,1,0,0,4
"TFRC",0,1,0,3,0,0,4
"TGIF1",0,2,0,1,0,1,4
"TGM3",0,1,3,0,0,0,4
"TIAL1",0,2,0,0,0,2,4
"TIGAR",0,1,0,2,0,1,4
"TIRAP",0,2,0,0,1,1,4
"TMED6",0,1,1,1,0,1,4
"TNFAIP1",0,0,1,0,1,2,4
"TNFRSF11B",0,1,0,2,1,0,4
"TNFSF12",0,1,0,2,0,1,4
"TNKS2",0,3,0,0,0,1,4
"TNR",2,0,0,2,0,0,4
"TPM3",0,2,0,2,0,0,4
"TPP1",0,2,0,2,0,0,4
"TPT1",0,1,0,1,2,0,4
"TRAK1",0,2,0,0,0,2,4
"TRIM63",0,2,0,2,0,0,4
"TRPM6",0,3,0,0,1,0,4
"TRPM8",0,0,1,0,3,0,4
"TRRAP",0,2,0,0,1,1,4
"TSPAN12",0,4,0,0,0,0,4
"TTF1",1,0,1,1,0,1,4
"TXNRD2",0,1,0,2,0,1,4
"TYRO3",0,3,1,0,0,0,4
"U6",0,1,0,2,0,1,4
"UGT1A3",1,0,0,3,0,0,4
"UGT1A4",1,0,0,3,0,0,4
"UGT1A8",0,3,0,1,0,0,4
"UGT2B4",0,0,2,2,0,0,4
"UNC5D",0,4,0,0,0,0,4
"UNG",0,3,0,1,0,0,4
"UPF1",0,2,0,0,0,2,4
"UPRT",0,1,0,0,2,1,4
"USF2",0,2,0,1,0,1,4
"UVRAG",0,3,0,0,0,1,4
"VASP",0,2,0,2,0,0,4
"VAV3",0,1,0,0,0,3,4
"VEGFD",0,2,1,0,0,1,4
"VIT",0,1,3,0,0,0,4
"WAPL",1,1,0,0,0,2,4
"WASL",0,1,1,0,0,2,4
"WDR48",0,3,0,1,0,0,4
"WISP3",2,1,0,0,0,1,4
"WNK2",0,2,1,0,0,1,4
"WNT4",0,2,0,1,0,1,4
"WWP1",0,1,0,2,1,0,4
"ZBTB33",0,3,0,0,1,0,4
"ZC3H12A",0,2,0,1,0,1,4
"ZIC2",0,2,1,0,0,1,4
"ZNF143",0,4,0,0,0,0,4
"ZNF146",0,2,0,0,2,0,4
"ZSCAN18",3,1,0,0,0,0,4
"ABCA1",0,0,0,3,0,0,3
"ABCC10",0,1,1,1,0,0,3
"ABCC6",1,1,0,1,0,0,3
"ABCG5",0,2,0,1,0,0,3
"ABL2",0,1,0,0,2,0,3
"ACAT1",0,1,0,2,0,0,3
"ACCS",0,0,0,1,2,0,3
"ACE2",1,1,0,0,0,1,3
"ACTN1",0,3,0,0,0,0,3
"ACVR2A",0,1,0,0,2,0,3
"ACY1",0,1,0,2,0,0,3
"ADAMTS13",0,2,0,1,0,0,3
"ADAMTS15",0,3,0,0,0,0,3
"ADAMTS9",0,1,0,0,1,1,3
"ADH1A",0,1,0,0,1,1,3
"ADM2",0,2,0,1,0,0,3
"ADO",0,1,0,2,0,0,3
"ADRA1B",0,2,0,0,0,1,3
"ADRA2A",2,1,0,0,0,0,3
"ADRB2",0,1,0,1,0,1,3
"AGL",0,0,0,0,3,0,3
"AHCYL1",1,0,0,1,0,1,3
"AIFM3",1,0,0,1,0,1,3
"AIMP2",0,1,0,1,0,1,3
"AIRE",0,0,1,1,0,1,3
"AKAP10",0,3,0,0,0,0,3
"AKAP13",0,2,0,1,0,0,3
"AKAP3",0,2,0,1,0,0,3
"AKR1C4",0,3,0,0,0,0,3
"AKR7A2",0,1,0,1,1,0,3
"ALDH1L1",0,1,0,1,1,0,3
"AMD1",0,3,0,0,0,0,3
"ANGPT2",0,2,0,0,1,0,3
"ANK3",0,1,0,1,0,1,3
"ANKRD11",0,0,1,2,0,0,3
"ANLN",0,1,0,0,1,1,3
"ANXA8",2,0,0,0,1,0,3
"AOC3",0,0,0,3,0,0,3
"AOX1",0,2,0,1,0,0,3
"API5",0,3,0,0,0,0,3
"APOBEC3B",0,0,0,3,0,0,3
"APOBEC3C",0,1,0,2,0,0,3
"APOC3",0,1,1,1,0,0,3
"AQP8",0,2,1,0,0,0,3
"ARF6",0,1,0,2,0,0,3
"ARHGAP26",0,1,0,0,2,0,3
"ARHGAP8",0,2,0,0,1,0,3
"ARHGDIB",0,1,0,0,1,1,3
"ARHGEF11",1,2,0,0,0,0,3
"ARID1B",0,1,1,0,1,0,3
"ARL6",0,2,0,1,0,0,3
"ASCC3",0,2,0,1,0,0,3
"ASPM",0,0,0,2,1,0,3
"ATP2A2",0,3,0,0,0,0,3
"ATP2B4",0,3,0,0,0,0,3
"ATP4A",0,0,0,0,0,3,3
"ATP5B",1,1,0,1,0,0,3
"BAG4",0,1,0,0,1,1,3
"BARD1",0,2,1,0,0,0,3
"BBC3",0,2,0,0,0,1,3
"BCL11A",0,2,0,0,1,0,3
"BLVRB",0,3,0,0,0,0,3
"BNIP3L",0,1,1,0,0,1,3
"BOP1",0,2,0,1,0,0,3
"BORA",0,3,0,0,0,0,3
"BRCC3",0,0,0,0,1,2,3
"BST2",0,1,0,0,0,2,3
"BTG3",1,0,1,1,0,0,3
"CA13",0,1,0,0,1,1,3
"CABYR",0,0,0,2,1,0,3
"CACNA2D3",0,0,1,0,0,2,3
"CACUL1",0,1,1,0,0,1,3
"CADM2",1,0,0,0,0,2,3
"CADM4",0,2,0,0,0,1,3
"CAPN10",0,1,1,0,1,0,3
"CAPZA2",0,0,1,1,0,1,3
"CASP8AP2",0,1,0,1,0,1,3
"CASQ1",0,0,0,0,1,2,3
"CBR1",0,0,0,2,1,0,3
"CCDC80",0,1,1,0,1,0,3
"CCR10",0,1,0,1,0,1,3
"CCR6",0,0,0,0,3,0,3
"CCT3",0,0,1,2,0,0,3
"CD109",1,2,0,0,0,0,3
"CD160",0,1,1,1,0,0,3
"CD209",0,3,0,0,0,0,3
"CDC27",0,1,0,1,1,0,3
"CDC34",0,1,0,2,0,0,3
"CDCA8",0,0,0,0,1,2,3
"CDH10",1,1,0,0,1,0,3
"CDK10",1,0,0,2,0,0,3
"CDK5",0,1,0,1,1,0,3
"CDK5RAP3",0,1,0,2,0,0,3
"CEBPA",0,1,0,1,0,1,3
"CELF2",0,2,0,0,1,0,3
"CERS6",0,2,0,1,0,0,3
"CHD2",0,2,0,0,0,1,3
"CHD9",0,1,0,1,0,1,3
"CITED1",0,3,0,0,0,0,3
"CITED2",0,1,1,0,0,1,3
"CIZ1",1,2,0,0,0,0,3
"CLDN10",0,0,0,3,0,0,3
"CLDN11",0,2,0,0,0,1,3
"CLDN8",0,2,0,0,0,1,3
"CLDN9",0,1,0,0,0,2,3
"CLIC4",0,0,0,3,0,0,3
"CLTB",1,0,0,1,1,0,3
"CMTM8",0,0,1,2,0,0,3
"CNDP2",0,1,0,0,1,1,3
"CNRIP1",1,2,0,0,0,0,3
"COL4A1",1,2,0,0,0,0,3
"COPA",0,0,0,2,0,1,3
"CPA6",0,0,1,1,0,1,3
"CPEB4",1,0,0,1,1,0,3
"CRCP",1,2,0,0,0,0,3
"CREM",0,2,0,1,0,0,3
"CRTC1",0,1,0,0,2,0,3
"CRYL1",0,0,0,3,0,0,3
"CSMD1",0,1,0,2,0,0,3
"CSTA",0,2,1,0,0,0,3
"CTSL",1,0,0,1,0,1,3
"CUL3",0,0,0,3,0,0,3
"CXCL11",0,2,0,0,0,1,3
"CYFIP2",0,1,0,0,0,2,3
"CYP26A1",0,2,0,0,0,1,3
"CYP2B6",0,1,1,1,0,0,3
"CYP7B1",0,0,0,3,0,0,3
"CYTL1",1,1,0,1,0,0,3
"DACT2",0,0,2,1,0,0,3
"DACT3",0,2,1,0,0,0,3
"DAG1",0,1,0,1,1,0,3
"DCD",0,0,0,1,1,1,3
"DDX6",0,2,0,0,0,1,3
"DEFA6",0,2,0,0,0,1,3
"DERL1",0,1,1,0,1,0,3
"DHODH",0,3,0,0,0,0,3
"DIRAS3",0,0,1,1,1,0,3
"DIS3",0,3,0,0,0,0,3
"DISC1",0,2,0,0,1,0,3
"DISP3",0,0,0,1,1,1,3
"DLG5",0,2,0,0,1,0,3
"DMC1",0,0,1,1,0,1,3
"DOHH",0,1,0,2,0,0,3
"DOK2",0,2,0,0,0,1,3
"DOT1L",0,2,1,0,0,0,3
"DSTN",0,0,0,1,1,1,3
"DUSP2",0,1,0,0,1,1,3
"DUSP5",0,2,0,0,0,1,3
"DYRK2",0,1,0,0,0,2,3
"E2F5",0,1,0,2,0,0,3
"EEF2K",0,2,0,0,0,1,3
"EGLN2",0,3,0,0,0,0,3
"EGR2",0,0,0,1,0,2,3
"EIF3H",0,3,0,0,0,0,3
"EME1",0,3,0,0,0,0,3
"EPC1",0,1,1,0,1,0,3
"EPC2",0,0,3,0,0,0,3
"EPHB6",0,1,0,2,0,0,3
"EPS8",0,2,0,0,1,0,3
"ERAP1",0,2,1,0,0,0,3
"F11",0,1,0,1,0,1,3
"F2RL3",0,2,0,1,0,0,3
"FABP6",0,3,0,0,0,0,3
"FAF1",0,1,0,0,0,2,3
"FAM134B",0,3,0,0,0,0,3
"FAM3C",0,0,0,1,2,0,3
"FANCE",0,0,2,0,0,1,3
"FBLN1",0,1,0,1,0,1,3
"FBXO39",0,1,0,1,0,1,3
"FBXW11",0,2,0,0,0,1,3
"FCGR3A",0,2,0,0,0,1,3
"FERMT1",0,3,0,0,0,0,3
"FGA",0,2,0,0,1,0,3
"FGF10",2,1,0,0,0,0,3
"FGF17",0,1,0,2,0,0,3
"FGF8",0,0,1,1,0,1,3
"FGFBP1",1,0,0,2,0,0,3
"FGL1",0,0,0,3,0,0,3
"FIS1",1,2,0,0,0,0,3
"FKBP2",0,2,1,0,0,0,3
"FKBP5",0,0,0,0,3,0,3
"FLI1",0,2,1,0,0,0,3
"FLNC",0,0,1,0,0,2,3
"FLOT1",0,1,0,2,0,0,3
"FMN2",0,1,0,0,2,0,3
"FNBP1",0,1,0,0,1,1,3
"FOXR1",0,0,1,1,1,0,3
"FOXRED1",0,2,0,0,0,1,3
"FPR2",0,1,0,2,0,0,3
"FRMD1",0,0,0,1,1,1,3
"FRMD6",0,0,0,1,1,1,3
"FXYD1",0,1,0,1,1,0,3
"FXYD5",1,2,0,0,0,0,3
"FXYD6",2,0,0,0,1,0,3
"G6PC",1,0,0,2,0,0,3
"GAD2",0,1,0,1,1,0,3
"GART",0,1,1,1,0,0,3
"GAS1",0,1,0,0,0,2,3
"GATA2",0,1,0,1,0,1,3
"GDF2",0,0,0,2,1,0,3
"GDI2",1,0,0,0,1,1,3
"GEMIN4",0,0,2,1,0,0,3
"GFER",0,0,0,3,0,0,3
"GIT1",0,1,0,2,0,0,3
"GLB1",0,1,0,1,1,0,3
"GLP2R",0,3,0,0,0,0,3
"GLRX3",0,2,0,1,0,0,3
"GLS2",0,0,0,2,0,1,3
"GNAI1",0,1,0,2,0,0,3
"GNAO1",0,0,0,2,0,1,3
"GNLY",0,0,0,0,0,3,3
"GP6",0,1,2,0,0,0,3
"GPAA1",0,1,0,2,0,0,3
"GPRC5A",1,0,0,0,1,1,3
"GSDMA",0,0,0,0,0,3,3
"GSDMB",0,0,0,0,0,3,3
"GSTA3",0,2,0,1,0,0,3
"GTF2I",0,1,0,1,1,0,3
"GTPBP4",0,1,0,0,0,2,3
"GUCY2F",0,2,0,0,1,0,3
"GUSB",0,3,0,0,0,0,3
"HABP2",0,0,0,2,1,0,3
"HAS1",0,3,0,0,0,0,3
"HCAR2",0,3,0,0,0,0,3
"HDAC10",0,0,1,1,0,1,3
"HELQ",0,0,2,0,0,1,3
"HELT",0,1,0,0,1,1,3
"HES2",0,1,0,0,1,1,3
"HEXIM1",0,1,0,1,1,0,3
"HIST1H2AE",0,2,0,1,0,0,3
"HMBS",1,1,0,1,0,0,3
"HOXA2",1,0,1,0,0,1,3
"HOXA7",0,0,2,1,0,0,3
"HOXB6",0,2,0,0,1,0,3
"HOXB8",0,3,0,0,0,0,3
"HOXC8",0,1,2,0,0,0,3
"HOXD8",0,2,0,1,0,0,3
"HOXD9",1,0,1,1,0,0,3
"HPSE2",0,2,0,0,1,0,3
"HRK",0,1,0,0,1,1,3
"IFIT1",0,2,1,0,0,0,3
"IFIT2",0,1,1,0,0,1,3
"IFIT3",0,2,1,0,0,0,3
"IFNB1",0,2,0,1,0,0,3
"IGFBP6",0,1,0,0,1,1,3
"INHBB",0,3,0,0,0,0,3
"INPP5D",0,2,1,0,0,0,3
"INSIG1",0,0,0,1,1,1,3
"ITGA4",0,2,0,0,0,1,3
"ITPR3",0,1,0,0,0,2,3
"JDP2",0,1,0,1,1,0,3
"KAT6A",0,1,1,1,0,0,3
"KCMF1",0,1,0,0,0,2,3
"KCNE2",0,0,0,0,0,3,3
"KCNK16",0,1,0,0,0,2,3
"KCNK9",1,2,0,0,0,0,3
"KDM3A",0,2,0,0,0,1,3
"KDM4A",0,2,0,0,0,1,3
"KIF11",0,1,0,1,0,1,3
"KIF18A",0,3,0,0,0,0,3
"KIF22",0,1,1,0,0,1,3
"KIF23",0,1,0,1,0,1,3
"KIR3DL2",0,0,0,3,0,0,3
"KLB",1,1,0,1,0,0,3
"KLK13",0,1,0,0,0,2,3
"KMT2A",0,1,0,0,2,0,3
"KPNA2",0,0,1,2,0,0,3
"KRT1",0,0,1,2,0,0,3
"KRT23",0,3,0,0,0,0,3
"LARS",0,1,1,1,0,0,3
"LAT2",1,0,1,1,0,0,3
"LDOC1",0,0,1,0,1,1,3
"LGALS7",0,3,0,0,0,0,3
"LIG3",0,1,1,0,1,0,3
"LIMK2",0,2,0,0,1,0,3
"LNX1",0,0,0,1,1,1,3
"LRG1",1,1,0,0,0,1,3
"LRRC3B",0,1,0,0,0,2,3
"LRRC4C",0,1,0,1,0,1,3
"LSS",0,0,0,0,2,1,3
"LTBP4",0,2,1,0,0,0,3
"LZIC",1,0,0,0,1,1,3
"MACROD2",0,0,1,0,0,2,3
"MAD2L2",0,2,0,1,0,0,3
"MADCAM1",0,1,0,0,1,1,3
"MAFK",0,0,0,3,0,0,3
"MAGED1",0,1,0,0,2,0,3
"MAOA",0,0,1,1,0,1,3
"MAP2",0,2,0,0,0,1,3
"MAPK11",0,1,0,1,1,0,3
"MAPK12",0,2,0,1,0,0,3
"MAPRE3",0,2,0,0,0,1,3
"MCM2",1,1,0,1,0,0,3
"MCM4",0,0,3,0,0,0,3
"MECOM",0,2,0,0,0,1,3
"MIR125A",0,0,0,1,0,2,3
"MIR130B",0,1,0,1,0,1,3
"MIR133B",0,2,0,0,0,1,3
"MIR15A",0,2,0,1,0,0,3
"MIR15B",0,1,0,2,0,0,3
"MIR191",0,1,0,1,0,1,3
"MIR205",1,0,0,1,1,0,3
"MIR215",0,2,0,0,0,1,3
"MIR34C",1,1,0,1,0,0,3
"MKL1",0,1,0,2,0,0,3
"MKNK1",0,1,0,1,0,1,3
"MLK4",0,2,1,0,0,0,3
"MLLT4",0,2,0,1,0,0,3
"MLST8",0,0,0,1,0,2,3
"MLX",0,1,0,0,0,2,3
"MLXIPL",0,1,0,1,0,1,3
"MMAB",0,3,0,0,0,0,3
"MMP14",0,1,0,1,0,1,3
"MMP8",1,1,0,0,0,1,3
"MOB1B",0,0,0,1,1,1,3
"MR1",0,2,0,0,0,1,3
"MRGBP",0,3,0,0,0,0,3
"MSI1",0,0,0,1,0,2,3
"MSR1",0,0,0,1,2,0,3
"MT-ND1",1,0,0,2,0,0,3
"MTCH1",0,2,0,1,0,0,3
"MTMR3",0,1,0,0,0,2,3
"MTTP",0,1,0,2,0,0,3
"MYF5",0,0,1,1,0,1,3
"MYLK",0,1,0,0,0,2,3
"MYO18B",0,2,0,0,1,0,3
"MYO1A",0,2,0,0,0,1,3
"MYT1",0,1,0,1,0,1,3
"NANOGP8",0,3,0,0,0,0,3
"NAV1",0,2,0,0,0,1,3
"NCOA2",0,2,0,1,0,0,3
"NDP",0,2,0,1,0,0,3
"NDRG4",0,3,0,0,0,0,3
"NEFH",0,1,0,2,0,0,3
"NEFL",0,2,0,1,0,0,3
"NEO1",0,3,0,0,0,0,3
"NETO2",0,1,0,1,0,1,3
"NFAM1",0,1,1,1,0,0,3
"NFYA",0,0,0,2,0,1,3
"NHLH1",0,2,0,0,1,0,3
"NLN",0,1,1,0,0,1,3
"NMT2",0,2,1,0,0,0,3
"NMU",0,1,0,0,1,1,3
"NOB1",0,2,0,1,0,0,3
"NR1H3",1,2,0,0,0,0,3
"NR3C1",0,2,0,0,0,1,3
"NR4A3",0,2,0,1,0,0,3
"NSUN2",0,1,1,0,1,0,3
"NT5E",1,0,0,0,1,1,3
"NUAK2",0,1,0,0,1,1,3
"NUDT6",0,2,0,0,1,0,3
"NUP210",0,1,0,2,0,0,3
"NUPR1",0,1,0,0,2,0,3
"ORM2",1,1,0,1,0,0,3
"OSGIN1",0,0,0,3,0,0,3
"OSM",1,2,0,0,0,0,3
"OSR1",0,0,1,0,1,1,3
"PAK7",0,0,0,1,1,1,3
"PAPSS2",0,2,0,1,0,0,3
"PARD3",0,0,0,2,0,1,3
"PAX2",0,2,1,0,0,0,3
"PAX5",0,0,0,1,1,1,3
"PCCA",2,1,0,0,0,0,3
"PCTP",0,0,1,0,2,0,3
"PDCL2",0,1,0,1,0,1,3
"PDE4B",0,2,0,1,0,0,3
"PEA15",0,0,0,1,0,2,3
"PELP1",0,2,0,0,1,0,3
"PERP",0,1,1,0,0,1,3
"PFAS",0,1,0,0,2,0,3
"PFKFB3",0,2,0,1,0,0,3
"PFKFB4",0,1,0,2,0,0,3
"PHB",1,0,0,2,0,0,3
"PHF10",0,0,0,0,0,3,3
"PHF6",0,1,1,1,0,0,3
"PIAS3",0,0,0,0,0,3,3
"PIEZO1",0,0,0,1,0,2,3
"PIK3CD",0,3,0,0,0,0,3
"PIR",0,1,2,0,0,0,3
"PKLR",0,1,0,0,1,1,3
"PLA2G10",0,2,0,1,0,0,3
"PLCD1",0,1,1,0,0,1,3
"PLOD2",0,0,1,1,0,1,3
"PLXNA1",0,1,0,0,1,1,3
"PMEPA1",0,2,0,0,0,1,3
"PMP22",0,1,0,0,2,0,3
"PNPT1",0,1,0,0,1,1,3
"POLE",0,3,0,0,0,0,3
"POU2F1",0,1,0,0,1,1,3
"POU3F3",0,0,1,0,1,1,3
"PPIC",0,0,0,0,1,2,3
"PPL",0,0,3,0,0,0,3
"PRC1",0,1,0,1,1,0,3
"PRDM16",0,1,1,0,0,1,3
"PRIMA1",0,2,0,1,0,0,3
"PRKAG2",0,2,1,0,0,0,3
"PRKCDBP",0,2,0,0,0,1,3
"PRMT5",0,1,1,0,0,1,3
"PRODH",0,3,0,0,0,0,3
"PRX",0,1,1,0,0,1,3
"PSMA5",0,1,0,1,1,0,3
"PSMD4",0,1,0,1,1,0,3
"PTCHD3",0,1,0,1,1,0,3
"PTGDR",0,3,0,0,0,0,3
"PTGES3",1,1,1,0,0,0,3
"PTGIS",0,3,0,0,0,0,3
"PTPN12",0,2,0,0,1,0,3
"PTPRG",0,1,0,0,0,2,3
"PTPRO",0,2,0,1,0,0,3
"PTPRZ1",0,2,0,0,0,1,3
"PTS",0,1,1,0,1,0,3
"PVRL4",1,0,1,0,0,1,3
"RAB11A",1,0,1,0,0,1,3
"RAB1A",1,0,1,1,0,0,3
"RAB23",0,0,0,2,0,1,3
"RAB32",0,2,0,0,0,1,3
"RABGAP1L",1,0,1,1,0,0,3
"RACGAP1",0,0,0,2,1,0,3
"RAD21",0,3,0,0,0,0,3
"RAD9A",0,1,1,0,0,1,3
"RAMP2",0,2,0,0,1,0,3
"RAP2A",0,2,0,0,1,0,3
"RAP2B",0,1,0,1,1,0,3
"RARRES2",0,1,1,1,0,0,3
"RASA4",0,0,0,0,3,0,3
"RBM8A",0,3,0,0,0,0,3
"RBP1",1,2,0,0,0,0,3
"RECQL5",0,2,0,0,1,0,3
"REG3G",0,1,0,1,1,0,3
"RFC4",0,0,1,1,1,0,3
"RFWD2",0,0,0,1,0,2,3
"RGS16",0,1,0,1,1,0,3
"RHBDF2",0,0,3,0,0,0,3
"RIPK3",0,1,1,1,0,0,3
"RND1",0,0,1,0,0,2,3
"RPL15",0,0,1,1,0,1,3
"RPL27",0,2,0,1,0,0,3
"RPL30",0,1,1,1,0,0,3
"RPLP0",0,1,0,2,0,0,3
"RPLP2",1,1,0,0,1,0,3
"RPS12",0,1,0,0,0,2,3
"RPS29",0,2,0,0,0,1,3
"RRAS2",0,1,1,0,1,0,3
"RS1",2,0,0,1,0,0,3
"RSPO2",0,2,0,0,0,1,3
"S100A12",0,1,0,0,1,1,3
"S1PR1",1,1,1,0,0,0,3
"SAGE1",0,1,1,0,0,1,3
"SART1",0,2,0,1,0,0,3
"SCG5",0,2,0,0,0,1,3
"SCN5A",0,2,0,1,0,0,3
"SDCCAG8",0,1,1,0,0,1,3
"SDHD",0,2,0,0,0,1,3
"SEC63",0,0,0,1,0,2,3
"SEMA3A",0,1,0,0,2,0,3
"SETD2",0,3,0,0,0,0,3
"SF3B1",0,3,0,0,0,0,3
"SGPL1",0,2,0,0,0,1,3
"SH3BP5",0,1,0,0,0,2,3
"SIK1",0,2,0,0,1,0,3
"SIRPA",0,1,0,1,0,1,3
"SLC16A1",0,2,0,0,0,1,3
"SLC16A4",0,1,0,1,0,1,3
"SLC18A1",0,1,1,0,1,0,3
"SLC19A3",0,1,0,0,0,2,3
"SLC23A1",0,1,0,0,0,2,3
"SLC26A3",0,3,0,0,0,0,3
"SLC29A1",1,0,0,0,2,0,3
"SLC34A2",0,2,0,0,0,1,3
"SLC38A1",1,0,0,1,1,0,3
"SLC39A14",0,3,0,0,0,0,3
"SLCO1A2",0,0,0,1,1,1,3
"SLCO3A1",0,0,0,1,1,1,3
"SLCO4A1",0,1,0,1,1,0,3
"SMAP1",0,2,0,0,0,1,3
"SMARCA2",0,1,0,1,1,0,3
"SMARCA4",0,0,0,3,0,0,3
"SMARCB1",0,1,0,0,0,2,3
"SMC1A",0,2,0,1,0,0,3
"SMC2",0,1,0,1,0,1,3
"SNW1",0,2,0,0,1,0,3
"SOAT2",0,0,0,3,0,0,3
"SOST",0,1,1,0,0,1,3
"SOSTDC1",0,1,0,0,0,2,3
"SOX1",0,0,0,3,0,0,3
"SPDEF",0,3,0,0,0,0,3
"SPOP",0,1,0,1,0,1,3
"SPRED2",0,1,0,1,1,0,3
"SPRY1",0,1,0,1,1,0,3
"SPRY3",0,1,0,1,1,0,3
"SREBF2",0,1,0,1,1,0,3
"SRR",1,0,1,0,0,1,3
"SRSF2",0,2,0,1,0,0,3
"SRSF6",0,1,0,1,0,1,3
"SS18",0,1,0,1,0,1,3
"SSR2",0,0,0,1,2,0,3
"SSTR4",0,2,0,1,0,0,3
"ST3GAL6",0,1,0,1,0,1,3
"STAB1",0,1,0,2,0,0,3
"STAB2",0,1,0,2,0,0,3
"STARD7",0,0,0,2,1,0,3
"STAT4",0,1,0,2,0,0,3
"STAT5B",0,1,0,2,0,0,3
"STC2",0,1,0,0,1,1,3
"STIM1",0,0,0,3,0,0,3
"STIM2",0,2,0,1,0,0,3
"STK40",0,0,3,0,0,0,3
"STOM",0,0,0,1,0,2,3
"STOML2",1,0,0,0,0,2,3
"SULT2A1",0,0,0,3,0,0,3
"SURF1",0,1,1,0,0,1,3
"TAB2",0,1,0,2,0,0,3
"TAPBP",0,3,0,0,0,0,3
"TARBP2",0,2,0,0,0,1,3
"TAX1BP3",0,1,0,2,0,0,3
"TBK1",0,1,0,1,1,0,3
"TCF19",0,1,0,0,1,1,3
"TCF3",0,2,0,1,0,0,3
"TCN1",0,0,0,0,1,2,3
"TERF1",0,1,0,0,0,2,3
"TFAM",0,2,0,1,0,0,3
"TFEB",0,0,1,1,1,0,3
"TFR2",0,0,0,3,0,0,3
"TGFB3",0,0,0,1,2,0,3
"TLR10",0,1,0,1,1,0,3
"TLR8",0,2,1,0,0,0,3
"TM4SF4",0,1,0,2,0,0,3
"TNFAIP2",0,1,1,0,0,1,3
"TNFRSF14",0,1,1,0,0,1,3
"TNFRSF21",0,2,1,0,0,0,3
"TNFSF14",0,1,0,1,0,1,3
"TNK2",0,0,1,0,1,1,3
"TNRC6A",0,1,1,0,0,1,3
"TNRC6C",0,1,1,0,0,1,3
"TP53I3",0,0,1,1,0,1,3
"TP53INP1",0,1,0,1,1,0,3
"TPD52",1,0,0,1,1,0,3
"TRA2B",0,1,0,1,0,1,3
"TRAF3",0,1,1,0,0,1,3
"TRIB2",0,0,0,3,0,0,3
"TRIM31",0,0,0,0,1,2,3
"TRO",1,1,0,1,0,0,3
"TRPV5",0,2,0,0,1,0,3
"TSHR",0,0,0,2,0,1,3
"TSN",0,0,0,2,0,1,3
"UBA52",0,1,1,0,0,1,3
"UBD",0,2,0,1,0,0,3
"UBE2D3",0,0,3,0,0,0,3
"UBE2V2",0,1,0,0,0,2,3
"UBR5",0,2,1,0,0,0,3
"UCP3",0,0,0,2,1,0,3
"UGCG",0,2,0,0,0,1,3
"UGT1A9",0,3,0,0,0,0,3
"ULBP3",0,2,0,0,0,1,3
"URGCP",0,0,0,2,0,1,3
"USP14",1,2,0,0,0,0,3
"USP15",0,1,0,0,1,1,3
"USP9X",0,1,0,0,2,0,3
"VASH2",0,0,0,3,0,0,3
"VILL",0,2,1,0,0,0,3
"VLDLR",0,0,0,1,1,1,3
"VNN1",0,2,0,0,1,0,3
"VPS4B",0,1,0,1,0,1,3
"VTI1A",0,2,0,1,0,0,3
"WHSC1",0,1,0,1,0,1,3
"WHSC1L1",0,0,0,1,2,0,3
"WNK1",0,2,1,0,0,0,3
"WNT10A",0,1,0,0,0,2,3
"WWC1",0,0,0,1,1,1,3
"WWC2",0,0,0,1,1,1,3
"XCR1",0,3,0,0,0,0,3
"XPO4",0,0,0,3,0,0,3
"YWHAE",0,0,0,0,2,1,3
"ZBTB4",0,1,0,0,2,0,3
"ZKSCAN3",0,3,0,0,0,0,3
"ZMYM2",0,0,0,3,0,0,3
"ZNF165",0,1,0,1,0,1,3
"ZNF410",0,1,1,1,0,0,3
"ZNF703",0,1,0,0,1,1,3
"ZNF79",0,1,0,1,0,1,3
"AANAT",2,0,0,0,0,0,2
"AATK",0,1,0,0,0,1,2
"ABCA12",0,1,0,0,1,0,2
"ABCA3",0,1,0,1,0,0,2
"ABCA5",0,1,1,0,0,0,2
"ABCA7",0,2,0,0,0,0,2
"ABCC12",0,0,0,1,1,0,2
"ABCC8",0,2,0,0,0,0,2
"ABCF2",0,2,0,0,0,0,2
"ABCG1",0,1,0,1,0,0,2
"ACAN",0,0,0,1,0,1,2
"ACO2",0,1,0,0,0,1,2
"ACOT8",0,1,1,0,0,0,2
"ACP2",0,0,0,1,1,0,2
"ACP5",0,0,0,2,0,0,2
"ACRV1",0,0,0,1,1,0,2
"ACSL1",0,1,0,1,0,0,2
"ACSL5",0,2,0,0,0,0,2
"ACTL6A",0,1,0,1,0,0,2
"ACTR3",1,0,0,0,0,1,2
"ADAMDEC1",0,2,0,0,0,0,2
"ADAMTS12",0,2,0,0,0,0,2
"ADAMTS14",0,2,0,0,0,0,2
"ADAMTS16",0,1,1,0,0,0,2
"ADAMTS8",0,1,0,1,0,0,2
"ADRB1",1,0,0,0,1,0,2
"AGO3",0,1,0,1,0,0,2
"AGO4",0,1,0,1,0,0,2
"AGPAT9",0,2,0,0,0,0,2
"AGR3",1,0,0,1,0,0,2
"AHCY",0,2,0,0,0,0,2
"AHSG",0,1,0,1,0,0,2
"AK1",0,1,1,0,0,0,2
"AKAP8L",0,2,0,0,0,0,2
"ALAS1",1,0,0,1,0,0,2
"ALDH1B1",0,1,0,1,0,0,2
"ALS2CR12",0,0,1,0,0,1,2
"AMBRA1",1,1,0,0,0,0,2
"AMER1",0,2,0,0,0,0,2
"AMPD1",0,1,0,1,0,0,2
"AMY2A",0,0,0,0,1,1,2
"ANGPTL7",0,0,1,1,0,0,2
"ANK2",0,1,0,0,1,0,2
"AP2M1",0,1,1,0,0,0,2
"APLN",0,0,0,2,0,0,2
"APOBEC3F",0,0,0,2,0,0,2
"APOD",0,1,0,0,1,0,2
"APOLD1",0,2,0,0,0,0,2
"APTX",0,1,0,0,0,1,2
"ARF3",0,0,0,1,0,1,2
"ARF5",0,0,0,1,0,1,2
"ARG2",0,0,0,0,1,1,2
"ARHGAP24",0,0,0,1,1,0,2
"ARHGAP4",0,0,0,0,1,1,2
"ARHGAP5",0,0,0,1,1,0,2
"ARHGAP6",0,1,0,0,1,0,2
"ARHGEF2",0,0,0,0,2,0,2
"ARHGEF7",0,1,0,0,0,1,2
"ARHGEF9",0,0,0,2,0,0,2
"ARID4B",0,0,0,0,1,1,2
"ARL11",0,2,0,0,0,0,2
"ARL2",0,0,0,1,1,0,2
"ARL5A",0,1,0,1,0,0,2
"ARRB2",0,1,0,0,1,0,2
"ARSI",0,0,1,0,0,1,2
"ASB9",0,1,0,1,0,0,2
"ASGR1",0,1,0,1,0,0,2
"ASXL1",0,1,0,0,1,0,2
"ASXL2",0,1,0,0,1,0,2
"ASXL3",0,1,0,0,1,0,2
"ATAD2",0,1,0,1,0,0,2
"ATG10",0,2,0,0,0,0,2
"ATG2B",0,1,0,0,0,1,2
"ATG9B",0,1,0,0,0,1,2
"ATOX1",0,2,0,0,0,0,2
"ATP1A1",0,1,1,0,0,0,2
"ATP2A3",0,2,0,0,0,0,2
"ATP5A1",0,2,0,0,0,0,2
"ATPIF1",0,1,0,1,0,0,2
"B3GNT3",0,0,0,1,1,0,2
"B4GALT1",0,1,0,1,0,0,2
"BAG1",0,1,1,0,0,0,2
"BAIAP2L1",0,0,0,2,0,0,2
"BASP1",0,0,0,2,0,0,2
"BATF2",0,0,0,2,0,0,2
"BBS5",0,0,1,1,0,0,2
"BCL2A1",0,1,0,1,0,0,2
"BCL2L11",0,1,0,0,0,1,2
"BCL6B",0,0,0,0,0,2,2
"BDKRB2",0,0,0,0,0,2,2
"BNIP2",0,1,0,1,0,0,2
"BNIPL",0,0,0,2,0,0,2
"BOK",0,1,0,0,0,1,2
"BRD4",0,2,0,0,0,0,2
"BRD8",0,2,0,0,0,0,2
"BTBD7",0,0,0,2,0,0,2
"BTG2",0,0,0,0,1,1,2
"BTG4",0,1,0,0,0,1,2
"BTK",0,0,0,2,0,0,2
"C10orf10",0,1,0,1,0,0,2
"C10orf99",0,0,1,1,0,0,2
"C11orf53",0,2,0,0,0,0,2
"C1GALT1",0,1,0,1,0,0,2
"C1QBP",0,1,0,1,0,0,2
"C4BPA",1,0,0,0,1,0,2
"CA10",1,1,0,0,0,0,2
"CA6",0,2,0,0,0,0,2
"CA7",0,2,0,0,0,0,2
"CA8",0,2,0,0,0,0,2
"CABLES1",0,2,0,0,0,0,2
"CACNA1C",0,1,1,0,0,0,2
"CALB1",1,0,1,0,0,0,2
"CANX",0,0,1,1,0,0,2
"CAPN9",0,0,0,1,0,1,2
"CARD8",0,2,0,0,0,0,2
"CASP5",0,2,0,0,0,0,2
"CASP6",0,1,0,0,0,1,2
"CBFA2T3",0,0,0,1,0,1,2
"CBFB",0,1,0,0,0,1,2
"CBR3",0,1,1,0,0,0,2
"CBX4",0,0,0,2,0,0,2
"CBX8",0,0,1,1,0,0,2
"CCAR2",1,0,0,0,1,0,2
"CCDC40",1,0,0,1,0,0,2
"CCL18",0,1,0,0,0,1,2
"CCL8",0,1,0,0,0,1,2
"CCNDBP1",0,1,0,1,0,0,2
"CCNI",0,0,0,0,1,1,2
"CCNK",0,1,0,1,0,0,2
"CCT2",1,0,0,0,0,1,2
"CD3EAP",0,2,0,0,0,0,2
"CD8A",0,0,0,2,0,0,2
"CDC14A",0,1,0,0,0,1,2
"CDC23",0,2,0,0,0,0,2
"CDK13",0,1,0,1,0,0,2
"CDK16",0,1,0,0,1,0,2
"CDKN2C",0,0,0,2,0,0,2
"CEACAM8",0,0,1,1,0,0,2
"CENPF",0,1,0,1,0,0,2
"CEP55",0,2,0,0,0,0,2
"CETP",2,0,0,0,0,0,2
"CFD",0,1,0,0,0,1,2
"CFP",0,2,0,0,0,0,2
"CHN1",0,0,1,0,1,0,2
"CHN2",0,1,0,0,1,0,2
"CHRM3",0,2,0,0,0,0,2
"CHRNA3",0,0,1,0,0,1,2
"CHST15",0,1,1,0,0,0,2
"CHST4",1,0,0,1,0,0,2
"CIAO1",0,0,1,1,0,0,2
"CIDEC",0,0,0,2,0,0,2
"CLDN16",0,1,0,0,0,1,2
"CLDN17",0,1,0,0,0,1,2
"CLDN22",0,1,0,0,0,1,2
"CLDN6",0,1,0,0,0,1,2
"CLEC3B",0,2,0,0,0,0,2
"CLEC4C",0,0,1,1,0,0,2
"CLEC4G",0,1,0,1,0,0,2
"CLIP1",0,1,0,0,1,0,2
"CLPS",0,0,0,1,1,0,2
"CLSPN",0,1,0,0,1,0,2
"CLUAP1",0,2,0,0,0,0,2
"CMKLR1",0,1,1,0,0,0,2
"CMTM3",0,1,0,0,0,1,2
"CNTN2",0,1,0,1,0,0,2
"COL3A1",0,0,0,1,0,1,2
"COLCA1",0,2,0,0,0,0,2
"COPS8",0,0,0,0,0,2,2
"CORIN",0,1,0,0,0,1,2
"COX5A",0,1,0,0,0,1,2
"CPA4",0,1,0,1,0,0,2
"CPB1",0,0,0,0,2,0,2
"CPB2",0,0,0,1,0,1,2
"CPE",0,0,0,1,0,1,2
"CR1",1,0,0,0,0,1,2
"CREB3L3",0,0,0,2,0,0,2
"CRIP1",0,0,0,0,0,2,2
"CRMP1",0,0,1,1,0,0,2
"CRNN",0,0,2,0,0,0,2
"CRY2",0,1,0,1,0,0,2
"CSMD2",0,1,0,0,1,0,2
"CSN2",0,1,0,0,1,0,2
"CSNK1D",0,1,0,0,0,1,2
"CST5",0,2,0,0,0,0,2
"CTAGE1",0,1,1,0,0,0,2
"CTBP2",0,1,0,1,0,0,2
"CTCFL",0,2,0,0,0,0,2
"CTNNA2",0,0,0,1,0,1,2
"CTNNA3",0,1,0,0,1,0,2
"CTNND2",0,0,2,0,0,0,2
"CTPS1",0,0,0,2,0,0,2
"CUL4B",0,2,0,0,0,0,2
"CXADR",0,0,0,0,0,2,2
"CXCL14",0,0,0,1,1,0,2
"CYBRD1",0,2,0,0,0,0,2
"CYP11A1",0,1,1,0,0,0,2
"CYP2C18",0,0,0,1,0,1,2
"CYP2R1",0,1,0,1,0,0,2
"CYP4B1",0,1,0,1,0,0,2
"CYP4F11",0,0,0,2,0,0,2
"CYP4F3",0,0,0,2,0,0,2
"DAD1",0,0,0,2,0,0,2
"DAND5",0,1,0,0,0,1,2
"DAP3",0,0,1,0,0,1,2
"DBT",0,1,1,0,0,0,2
"DCT",1,1,0,0,0,0,2
"DDB2",0,2,0,0,0,0,2
"DDIAS",0,1,0,0,1,0,2
"DDOST",0,0,1,0,1,0,2
"DDX17",0,2,0,0,0,0,2
"DDX20",0,0,0,2,0,0,2
"DEFA1",0,2,0,0,0,0,2
"DEK",0,1,0,1,0,0,2
"DEPDC5",0,0,0,2,0,0,2
"DIDO1",0,2,0,0,0,0,2
"DIRAS1",0,1,1,0,0,0,2
"DISP1",0,0,0,0,1,1,2
"DISP2",0,0,0,0,1,1,2
"DKC1",0,2,0,0,0,0,2
"DNAH8",0,1,0,0,0,1,2
"DNAJB4",0,0,0,0,0,2,2
"DNM3",0,1,0,1,0,0,2
"DOCK8",0,0,1,1,0,0,2
"DPCR1",0,1,0,0,0,1,2
"DPT",0,0,0,2,0,0,2
"DPYS",0,1,0,0,0,1,2
"DRAXIN",0,2,0,0,0,0,2
"DSCC1",0,2,0,0,0,0,2
"DSE",0,1,1,0,0,0,2
"DUOXA2",0,1,0,0,1,0,2
"DYM",0,0,1,0,0,1,2
"DYRK1A",0,1,0,1,0,0,2
"E2F3P1",0,0,0,2,0,0,2
"ECHS1",0,0,0,2,0,0,2
"EDA2R",0,2,0,0,0,0,2
"EDN2",0,1,0,0,0,1,2
"EDN3",0,2,0,0,0,0,2
"EDNRA",0,0,0,0,1,1,2
"EEF1E1",0,1,0,0,0,1,2
"EEF1G",0,1,0,1,0,0,2
"EFEMP2",0,1,0,0,0,1,2
"EIF2AK4",0,2,0,0,0,0,2
"EIF3C",0,2,0,0,0,0,2
"EIF4A1",0,1,0,1,0,0,2
"EIF4A3",0,0,0,1,0,1,2
"ELAC1",0,0,2,0,0,0,2
"ELAVL2",0,0,0,0,1,1,2
"ELF3",1,1,0,0,0,0,2
"ELL",0,0,0,2,0,0,2
"ELMO1",0,1,1,0,0,0,2
"ENC1",0,2,0,0,0,0,2
"ENOSF1",0,2,0,0,0,0,2
"ENSA",0,0,0,2,0,0,2
"ENTPD1",0,0,0,2,0,0,2
"ENTPD5",0,1,0,1,0,0,2
"EPB41L3",0,0,0,0,1,1,2
"EPHA5",0,0,0,2,0,0,2
"EPHA6",0,1,0,1,0,0,2
"EPHX4",0,1,0,1,0,0,2
"EPS15",0,1,0,1,0,0,2
"EPX",0,1,0,1,0,0,2
"ERAP2",0,2,0,0,0,0,2
"ERC1",0,1,0,1,0,0,2
"ERC2",0,1,0,1,0,0,2
"ERCC6",0,1,0,0,0,1,2
"ERF",0,0,1,0,0,1,2
"ERH",0,0,0,1,0,1,2
"ERP29",1,0,0,1,0,0,2
"ESRP1",0,1,0,0,1,0,2
"EVPL",0,0,2,0,0,0,2
"F5",0,0,0,1,1,0,2
"FAAH",0,2,0,0,0,0,2
"FAM162A",0,1,1,0,0,0,2
"FANCG",0,1,0,0,1,0,2
"FARSB",0,1,1,0,0,0,2
"FBXO11",0,0,0,0,1,1,2
"FBXO4",0,0,0,2,0,0,2
"FCGR2A",0,1,0,0,0,1,2
"FEM1B",0,2,0,0,0,0,2
"FER",0,1,0,1,0,0,2
"FERMT2",0,1,0,0,0,1,2
"FFAR2",1,1,0,0,0,0,2
"FGF12",0,0,1,0,0,1,2
"FGF16",0,1,0,0,1,0,2
"FHOD1",0,0,0,0,2,0,2
"FILIP1L",1,0,0,0,1,0,2
"FKBP15",1,1,0,0,0,0,2
"FLCN",0,2,0,0,0,0,2
"FN3K",0,2,0,0,0,0,2
"FOSB",0,1,0,0,1,0,2
"FOXB1",0,0,0,1,1,0,2
"FOXJ1",0,0,0,1,1,0,2
"FOXJ2",1,0,0,0,1,0,2
"FOXK2",0,1,0,0,1,0,2
"FOXN2",0,0,0,0,1,1,2
"FOXO6",0,0,0,0,1,1,2
"FTCD",0,0,1,1,0,0,2
"FUCA1",0,2,0,0,0,0,2
"FUK",0,0,1,0,1,0,2
"FUT7",0,1,0,0,1,0,2
"FZD2",0,0,1,0,0,1,2
"GAD1",0,0,0,0,2,0,2
"GAL3ST1",0,0,0,2,0,0,2
"GALNT2",0,1,0,1,0,0,2
"GALNT3",0,1,0,0,1,0,2
"GALR1",0,1,1,0,0,0,2
"GAP43",0,1,0,0,1,0,2
"GAPDHS",0,1,0,0,0,1,2
"GAS6",0,1,0,0,0,1,2
"GATA1",0,0,1,0,0,1,2
"GBE1",0,0,0,2,0,0,2
"GCLC",0,0,0,2,0,0,2
"GCSH",0,2,0,0,0,0,2
"GFRA1",0,0,0,0,2,0,2
"GJA1",0,1,1,0,0,0,2
"GJB6",0,1,0,0,0,1,2
"GLRX",0,1,0,0,1,0,2
"GLS",0,0,0,2,0,0,2
"GLTSCR2",0,0,0,1,0,1,2
"GLUD1",1,0,0,1,0,0,2
"GNA11",0,1,0,0,1,0,2
"GNPDA1",0,1,0,1,0,0,2
"GOSR1",0,0,1,1,0,0,2
"GPC6",0,0,0,1,1,0,2
"GPD1",0,1,0,1,0,0,2
"GPR1",0,1,0,0,0,1,2
"GPR161",0,1,0,0,0,1,2
"GPR34",0,0,0,0,0,2,2
"GPR39",0,1,1,0,0,0,2
"GPT2",0,0,1,1,0,0,2
"GRASP",0,1,1,0,0,0,2
"GREM2",0,1,0,0,0,1,2
"GRIN2B",1,1,0,0,0,0,2
"GRK5",0,2,0,0,0,0,2
"GSDMC",0,1,0,0,0,1,2
"GSPT2",0,0,0,1,1,0,2
"GSTA5",0,0,0,2,0,0,2
"GSTT2",0,1,0,0,0,1,2
"HBE1",1,1,0,0,0,0,2
"HCFC1",0,1,0,1,0,0,2
"HCG27",0,0,0,0,0,2,2
"HCRT",0,1,0,0,1,0,2
"HEPACAM",0,0,0,2,0,0,2
"HEPH",0,2,0,0,0,0,2
"HEPN1",0,0,0,2,0,0,2
"HHIPL2",0,0,0,0,1,1,2
"HINT2",0,0,0,2,0,0,2
"HIPK1",0,1,0,0,0,1,2
"HIPK3",0,0,0,1,0,1,2
"HIST1H1C",0,1,0,0,1,0,2
"HJURP",0,2,0,0,0,0,2
"HLA-DQA1",0,0,0,0,0,2,2
"HLA-DRA",0,2,0,0,0,0,2
"HM13",0,1,0,1,0,0,2
"HMCN1",1,0,0,0,0,1,2
"HMGB2",0,1,0,1,0,0,2
"HMOX2",0,1,0,1,0,0,2
"HNRNPA2B1",0,0,0,1,1,0,2
"HNRNPF",0,1,0,1,0,0,2
"HOTTIP",0,0,0,2,0,0,2
"HOXA3",0,1,0,0,1,0,2
"HOXB3",0,0,0,0,1,1,2
"HOXD1",0,2,0,0,0,0,2
"HPRT1",0,2,0,0,0,0,2
"HSD11B1",0,1,0,1,0,0,2
"HSD17B4",0,1,1,0,0,0,2
"HSD3B1",0,0,0,1,0,1,2
"HSP90AB1",0,1,0,1,0,0,2
"HSPB8",0,2,0,0,0,0,2
"IER2",0,1,0,0,1,0,2
"IFI16",0,0,0,1,1,0,2
"IFI6",0,1,0,1,0,0,2
"IFITM3",0,2,0,0,0,0,2
"IGDCC3",0,0,0,2,0,0,2
"IGFALS",0,1,0,1,0,0,2
"IGJ",0,1,0,0,1,0,2
"IGSF11",0,0,0,0,0,2,2
"IL10RA",0,1,0,0,0,1,2
"IL10RB",0,2,0,0,0,0,2
"IL11",0,0,0,0,0,2,2
"IL12A",0,0,1,0,0,1,2
"IL20",0,0,0,2,0,0,2
"INSC",0,1,0,0,1,0,2
"INVS",0,2,0,0,0,0,2
"IPP",0,0,0,1,0,1,2
"IRF6",0,2,0,0,0,0,2
"ITGA2B",0,2,0,0,0,0,2
"ITGA7",0,2,0,0,0,0,2
"ITGB5",0,1,0,0,0,1,2
"ITIH3",0,0,0,0,0,2,2
"ITLN1",0,0,0,1,0,1,2
"JMJD1C",0,0,1,0,0,1,2
"KAT5",1,0,0,0,0,1,2
"KAT7",0,0,1,0,1,0,2
"KCNH1",0,1,0,1,0,0,2
"KCNK15",0,1,0,0,0,1,2
"KCNK5",0,1,0,0,0,1,2
"KDM4D",0,2,0,0,0,0,2
"KHDRBS3",0,1,0,0,0,1,2
"KIAA1598",1,0,0,1,0,0,2
"KIF3A",0,2,0,0,0,0,2
"KIF3B",0,1,0,1,0,0,2
"KIR2DL3",0,1,0,1,0,0,2
"KLF14",0,1,0,1,0,0,2
"KLF9",0,1,0,1,0,0,2
"KLK4",0,2,0,0,0,0,2
"KMO",1,1,0,0,0,0,2
"KMT2B",0,0,0,2,0,0,2
"KMT2D",0,0,2,0,0,0,2
"KREMEN2",0,1,0,0,1,0,2
"KRT10",0,1,0,0,0,1,2
"KRT5",2,0,0,0,0,0,2
"LAG3",0,1,1,0,0,0,2
"LAMB3",0,0,0,0,0,2,2
"LAMP2",0,1,0,0,1,0,2
"LAMTOR5",0,0,0,2,0,0,2
"LATS1",0,0,1,1,0,0,2
"LDB1",0,0,0,1,1,0,2
"LIMS2",0,0,0,1,0,1,2
"LINGO2",0,0,0,0,1,1,2
"LLGL1",0,1,1,0,0,0,2
"LMTK3",0,1,0,0,0,1,2
"LOXL1",0,1,0,1,0,0,2
"LOXL4",0,1,0,1,0,0,2
"LPA",0,1,0,1,0,0,2
"LRP1",0,0,0,1,1,0,2
"LRP8",0,0,0,0,1,1,2
"LRRC24",0,1,0,1,0,0,2
"LRRC32",0,1,0,1,0,0,2
"LRRFIP2",0,2,0,0,0,0,2
"LTB4R2",0,0,1,0,1,0,2
"LTBP2",0,1,0,1,0,0,2
"LTBP3",1,0,0,0,0,1,2
"LTF",0,2,0,0,0,0,2
"LUM",0,0,1,0,1,0,2
"LXN",0,1,0,0,0,1,2
"LY6D",0,2,0,0,0,0,2
"LY6E",0,0,0,0,2,0,2
"LZTS1",0,0,1,0,0,1,2
"MAFG",1,0,0,1,0,0,2
"MAGEA1",0,2,0,0,0,0,2
"MAGI2",0,2,0,0,0,0,2
"MAL2",1,0,0,0,1,0,2
"MALT1",0,0,0,0,0,2,2
"MAP1B",0,2,0,0,0,0,2
"MAP1S",0,2,0,0,0,0,2
"MAP2K5",0,2,0,0,0,0,2
"MAP3K3",0,2,0,0,0,0,2
"MAP4K1",0,1,0,0,1,0,2
"MAPK4",0,0,0,1,0,1,2
"MAPKAP1",0,0,0,2,0,0,2
"MAPKAPK2",0,0,0,0,2,0,2
"MAPRE1",0,1,0,0,0,1,2
"MAPRE2",0,1,0,0,1,0,2
"MARK1",0,0,0,0,0,2,2
"MARS",0,1,0,1,0,0,2
"MASTL",0,1,0,1,0,0,2
"MCM10",0,1,1,0,0,0,2
"ME1",0,1,0,1,0,0,2
"MED19",0,0,0,1,0,1,2
"MED29",0,0,0,0,2,0,2
"MEF2A",0,0,0,1,0,1,2
"MEST",0,2,0,0,0,0,2
"METAP1",0,2,0,0,0,0,2
"MFHAS1",0,1,0,0,0,1,2
"MGEA5",0,0,0,1,0,1,2
"MGLL",0,1,0,0,1,0,2
"MICU1",1,1,0,0,0,0,2
"MIEN1",0,0,0,0,0,2,2
"MIR100",0,0,1,1,0,0,2
"MIR149",0,1,0,0,0,1,2
"MIR152",0,0,0,2,0,0,2
"MIR182",0,0,0,1,0,1,2
"MIR204",0,0,1,0,0,1,2
"MIR301A",0,0,1,0,0,1,2
"MIR30A",0,1,0,1,0,0,2
"MIR320A",0,1,0,1,0,0,2
"MIR409",0,0,0,0,0,2,2
"MIR424",0,1,0,0,1,0,2
"MIR483",0,1,0,0,1,0,2
"MIR520H",0,1,0,0,1,0,2
"MIR99A",0,0,0,2,0,0,2
"MLKL",0,1,1,0,0,0,2
"MMP17",0,2,0,0,0,0,2
"MMP23B",0,1,0,0,0,1,2
"MMP25",0,2,0,0,0,0,2
"MMRN1",0,1,0,1,0,0,2
"MOG",0,2,0,0,0,0,2
"MOK",0,1,0,1,0,0,2
"MPG",0,0,0,2,0,0,2
"MPZL1",0,0,0,2,0,0,2
"MRAP",2,0,0,0,0,0,2
"MRPL12",0,1,0,0,1,0,2
"MRVI1",0,1,0,0,1,0,2
"MS4A12",0,2,0,0,0,0,2
"MSI2",0,1,0,0,0,1,2
"MSRA",0,1,0,1,0,0,2
"MT-CO2",0,1,0,1,0,0,2
"MT-ND2",0,0,0,0,2,0,2
"MTBP",1,0,0,1,0,0,2
"MTF1",0,1,0,0,1,0,2
"MTM1",0,1,0,0,0,1,2
"MUM1",0,1,0,1,0,0,2
"MUSK",0,1,0,0,0,1,2
"MYO10",0,2,0,0,0,0,2
"MYO1E",0,1,0,1,0,0,2
"MYO3A",0,1,0,0,0,1,2
"MYO5B",0,0,0,0,0,2,2
"MYOG",0,0,1,1,0,0,2
"NAIF1",0,0,1,0,0,1,2
"NAP1L1",0,2,0,0,0,0,2
"NAT10",0,1,1,0,0,0,2
"NAV2",0,2,0,0,0,0,2
"NAV3",0,1,0,0,1,0,2
"NCAM2",1,1,0,0,0,0,2
"NCF4",0,2,0,0,0,0,2
"NCOA1",0,1,0,0,1,0,2
"NCOA5",0,0,0,2,0,0,2
"NDUFC2",0,2,0,0,0,0,2
"NEFM",0,0,1,0,1,0,2
"NEK7",1,0,0,1,0,0,2
"NELL1",0,1,0,1,0,0,2
"NET1",0,0,0,0,0,2,2
"NEU4",0,2,0,0,0,0,2
"NFE2",0,2,0,0,0,0,2
"NID2",0,1,0,0,0,1,2
"NKRF",0,1,0,1,0,0,2
"NKX2-3",0,2,0,0,0,0,2
"NLRC4",0,1,0,0,0,1,2
"NME1-NME2",0,0,0,2,0,0,2
"NNAT",0,0,1,1,0,0,2
"NOC3L",0,1,0,0,0,1,2
"NONO",0,2,0,0,0,0,2
"NOX5",0,1,0,0,1,0,2
"NPAS2",0,1,0,1,0,0,2
"NPM3",0,1,0,0,0,1,2
"NPPA",0,1,1,0,0,0,2
"NPPB",0,2,0,0,0,0,2
"NRCAM",0,0,0,1,1,0,2
"NRG2",0,1,0,0,1,0,2
"NRXN3",0,1,0,1,0,0,2
"NTRK2",0,1,1,0,0,0,2
"NUPL1",0,2,0,0,0,0,2
"NUSAP1",0,0,0,1,1,0,2
"OGN",0,2,0,0,0,0,2
"OLFM1",0,0,1,0,1,0,2
"OPA1",1,1,0,0,0,0,2
"OPHN1",0,0,0,0,1,1,2
"OPN3",0,1,0,1,0,0,2
"OPTN",0,0,0,2,0,0,2
"OSBP",1,0,0,1,0,0,2
"OSBP2",1,0,0,1,0,0,2
"OXCT1",0,0,0,2,0,0,2
"OXT",0,1,0,0,1,0,2
"P3H1",0,1,0,1,0,0,2
"PA2G4",0,1,1,0,0,0,2
"PABPC1",0,1,1,0,0,0,2
"PACRG",0,1,0,1,0,0,2
"PADI4",0,0,0,2,0,0,2
"PAGE4",0,1,0,1,0,0,2
"PAK6",0,1,0,1,0,0,2
"PALLD",0,0,0,0,2,0,2
"PAQR3",0,1,1,0,0,0,2
"PARPBP",0,0,0,0,2,0,2
"PATZ1",0,1,0,1,0,0,2
"PAX7",0,0,0,0,1,1,2
"PAX9",0,1,0,0,1,0,2
"PCDH17",0,1,0,0,0,1,2
"PCK1",0,1,0,1,0,0,2
"PCLO",1,0,0,1,0,0,2
"PDE3A",0,2,0,0,0,0,2
"PDGFC",0,0,0,2,0,0,2
"PDGFD",1,0,0,0,0,1,2
"PDK4",0,1,0,1,0,0,2
"PDRG1",0,2,0,0,0,0,2
"PDS5B",0,1,0,0,0,1,2
"PDZK1IP1",1,1,0,0,0,0,2
"PEG3",1,1,0,0,0,0,2
"PENK",0,1,0,0,1,0,2
"PES1",0,2,0,0,0,0,2
"PFDN4",0,1,0,0,0,1,2
"PFDN5",0,0,0,0,1,1,2
"PFKP",0,1,0,1,0,0,2
"PHEX",0,2,0,0,0,0,2
"PHF14",1,1,0,0,0,0,2
"PHLDA1",0,2,0,0,0,0,2
"PICK1",0,1,0,1,0,0,2
"PIGS",0,1,0,0,0,1,2
"PIK3CB",0,1,1,0,0,0,2
"PIK3R2",0,1,0,0,1,0,2
"PIK3R3",0,1,0,0,0,1,2
"PITX2",1,1,0,0,0,0,2
"PIWIL4",0,1,0,1,0,0,2
"PKP3",0,0,0,1,0,1,2
"PLA2G2D",0,1,0,0,0,1,2
"PLIN2",0,2,0,0,0,0,2
"PLOD1",0,1,1,0,0,0,2
"PLOD3",0,0,0,0,1,1,2
"PLP2",0,1,0,1,0,0,2
"PLS3",0,2,0,0,0,0,2
"PLXDC1",0,0,0,2,0,0,2
"PLXND1",0,1,0,0,0,1,2
"PNKP",0,2,0,0,0,0,2
"PNLIPRP2",0,0,0,0,2,0,2
"POPDC3",0,0,0,0,0,2,2
"POU2F3",0,0,0,1,0,1,2
"POU3F2",0,0,0,0,1,1,2
"PPHLN1",1,0,0,1,0,0,2
"PPM1A",0,0,0,1,0,1,2
"PPP1CB",0,1,0,0,0,1,2
"PPP1R1A",0,1,0,0,0,1,2
"PPP1R2",0,1,0,0,0,1,2
"PPP1R3B",0,1,0,0,0,1,2
"PPP1R3C",0,1,0,0,0,1,2
"PPP1R7",0,1,0,0,0,1,2
"PPP1R8",0,1,0,0,0,1,2
"PPP2R2B",0,1,0,1,0,0,2
"PPP6C",0,1,0,1,0,0,2
"PRDM4",0,0,0,0,1,1,2
"PREP",0,1,0,0,0,1,2
"PRKACB",1,0,0,1,0,0,2
"PRKG2",1,1,0,0,0,0,2
"PRKRIR",0,0,1,0,0,1,2
"PROKR1",0,1,0,1,0,0,2
"PROS1",0,1,0,1,0,0,2
"PRPF6",0,2,0,0,0,0,2
"PRSS8",0,0,1,0,0,1,2
"PSAP",1,0,0,0,1,0,2
"PSAT1",0,2,0,0,0,0,2
"PSEN2",0,0,0,0,2,0,2
"PSMA1",0,0,0,1,1,0,2
"PSMB10",0,0,0,1,0,1,2
"PSMB5",0,0,0,1,0,1,2
"PSMC3",0,0,0,0,1,1,2
"PSMC4",0,2,0,0,0,0,2
"PSME1",0,2,0,0,0,0,2
"PSRC1",0,1,0,1,0,0,2
"PTMA",0,1,0,1,0,0,2
"PTMS",0,1,0,0,0,1,2
"PTPN4",0,1,0,0,0,1,2
"PTPRA",0,0,0,0,0,2,2
"PTPRF",0,1,0,0,0,1,2
"PTPRH",0,0,0,1,0,1,2
"PTRF",0,1,0,0,0,1,2
"PTTG1IP",0,0,1,1,0,0,2
"PTTG2",0,1,0,1,0,0,2
"PTX3",0,1,1,0,0,0,2
"PVRL1",0,0,1,0,0,1,2
"PXDN",0,1,0,1,0,0,2
"PYCR1",0,2,0,0,0,0,2
"PYGM",0,0,0,0,2,0,2
"QKI",0,1,0,1,0,0,2
"QSOX1",0,0,0,1,1,0,2
"RAB10",0,1,0,1,0,0,2
"RAB1B",0,1,0,1,0,0,2
"RAB22A",0,1,0,1,0,0,2
"RAB27A",0,0,0,2,0,0,2
"RAC3",0,0,1,0,0,1,2
"RALGAPA2",0,1,0,0,1,0,2
"RANBP3",0,1,0,1,0,0,2
"RAP1A",0,1,1,0,0,0,2
"RAP1GDS1",0,0,0,0,2,0,2
"RAPGEF1",0,1,0,0,0,1,2
"RASGRF2",0,0,0,0,2,0,2
"RB1CC1",0,1,0,1,0,0,2
"RBFOX1",0,0,0,1,0,1,2
"RBFOX2",0,1,0,0,0,1,2
"RBM39",0,2,0,0,0,0,2
"RCOR1",0,1,0,1,0,0,2
"RECQL4",0,1,0,0,1,0,2
"REG1B",1,0,0,0,1,0,2
"RERG",0,1,0,1,0,0,2
"RGS2",0,1,0,1,0,0,2
"RGS4",0,1,0,0,1,0,2
"RGS5",0,0,0,1,0,1,2
"RHBDD1",0,1,0,1,0,0,2
"RHEB",0,0,0,2,0,0,2
"RHOXF2",0,0,0,0,1,1,2
"RHPN2",0,2,0,0,0,0,2
"RIT1",0,0,0,2,0,0,2
"RLF",0,1,0,0,0,1,2
"RNF111",0,1,1,0,0,0,2
"RNF14",0,2,0,0,0,0,2
"RNF2",0,0,1,1,0,0,2
"RNF8",0,1,1,0,0,0,2
"ROBO4",0,1,0,0,1,0,2
"ROMO1",0,0,0,2,0,0,2
"RORC",0,0,0,0,0,2,2
"RPH3AL",0,2,0,0,0,0,2
"RPL22",0,0,0,0,0,2,2
"RPL27A",0,2,0,0,0,0,2
"RPL28",0,1,1,0,0,0,2
"RPL29",0,0,0,1,0,1,2
"RPL35",0,0,0,2,0,0,2
"RPL7",0,1,1,0,0,0,2
"RPL8",0,2,0,0,0,0,2
"RPL9",0,0,0,2,0,0,2
"RPS10",0,1,0,1,0,0,2
"RPS13",0,0,0,0,0,2,2
"RPS15",0,0,0,1,1,0,2
"RPS2",0,1,0,1,0,0,2
"RPS20",0,2,0,0,0,0,2
"RPS5",0,1,0,1,0,0,2
"RPS6KA6",0,2,0,0,0,0,2
"RPS9",0,1,0,0,1,0,2
"RTKN",0,0,0,0,0,2,2
"RTN4",0,1,0,1,0,0,2
"RUNDC3B",0,1,0,0,1,0,2
"S100A13",0,1,0,0,1,0,2
"S100A3",0,1,0,0,0,1,2
"S100A7",0,0,0,0,0,2,2
"SAA4",0,1,0,1,0,0,2
"SAG",0,1,0,1,0,0,2
"SARS",0,2,0,0,0,0,2
"SASS6",0,2,0,0,0,0,2
"SAT2",0,0,0,2,0,0,2
"SCAMP1",1,0,0,0,1,0,2
"SCARA5",0,0,0,2,0,0,2
"SCARB1",0,0,0,2,0,0,2
"SCGB2A2",0,1,0,0,0,1,2
"SCN2A",0,2,0,0,0,0,2
"SCN8A",0,1,1,0,0,0,2
"SCX",0,1,0,1,0,0,2
"SDC4",0,0,0,1,1,0,2
"SDCBP",0,0,0,0,0,2,2
"SDHB",0,1,0,0,0,1,2
"SDHC",0,1,0,0,0,1,2
"SEC11A",0,0,0,0,0,2,2
"SEC14L2",0,1,0,0,0,1,2
"SEC23A",1,0,0,1,0,0,2
"SEMA3C",0,0,0,1,0,1,2
"SERPINA5",0,0,0,2,0,0,2
"SERPINI1",0,0,0,1,0,1,2
"SERTAD1",0,1,1,0,0,0,2
"SERTAD2",0,1,0,1,0,0,2
"SETD7",0,1,0,1,0,0,2
"SGCE",0,1,0,1,0,0,2
"SGPP1",0,0,1,0,0,1,2
"SGTA",0,0,0,2,0,0,2
"SH2B1",0,1,1,0,0,0,2
"SHB",0,0,0,2,0,0,2
"SHOX2",1,0,0,1,0,0,2
"SIGIRR",0,2,0,0,0,0,2
"SIM2",0,1,1,0,0,0,2
"SIN3A",0,1,0,1,0,0,2
"SIRT5",0,1,0,1,0,0,2
"SIX3",0,1,0,0,0,1,2
"SLBP",0,0,0,1,0,1,2
"SLC16A12",0,1,0,0,0,1,2
"SLC16A3",0,1,0,1,0,0,2
"SLC22A12",0,2,0,0,0,0,2
"SLC25A4",0,2,0,0,0,0,2
"SLC6A4",0,2,0,0,0,0,2
"SLIT1",0,2,0,0,0,0,2
"SLU7",0,0,0,2,0,0,2
"SMARCC1",0,1,0,0,1,0,2
"SMR3B",0,0,0,2,0,0,2
"SMURF2",0,1,0,0,1,0,2
"SNCAIP",0,2,0,0,0,0,2
"SNRPN",0,2,0,0,0,0,2
"SNX1",0,2,0,0,0,0,2
"SORBS2",0,0,1,0,1,0,2
"SORBS3",0,0,0,1,1,0,2
"SORT1",0,2,0,0,0,0,2
"SOX3",0,0,0,0,1,1,2
"SOX5",0,1,1,0,0,0,2
"SPA17",0,0,0,2,0,0,2
"SPAG9",0,1,0,1,0,0,2
"SPATA5",0,1,0,0,1,0,2
"SPC24",0,1,0,0,0,1,2
"SPC25",0,1,0,0,0,1,2
"SPEN",0,0,0,0,2,0,2
"SPON2",0,0,0,1,0,1,2
"SPRED1",0,1,0,0,1,0,2
"SPRED3",0,1,0,0,1,0,2
"SPTAN1",0,1,0,0,0,1,2
"SRGAP2",0,0,0,0,2,0,2
"SRM",0,2,0,0,0,0,2
"SRP68",0,1,1,0,0,0,2
"SRPK1",0,2,0,0,0,0,2
"SRPX",0,1,0,0,1,0,2
"SSH1",0,1,0,0,0,1,2
"SSH2",0,1,0,0,0,1,2
"SSX2IP",0,0,0,1,0,1,2
"ST8SIA2",0,0,0,1,1,0,2
"STAG1",0,1,0,1,0,0,2
"STAM",0,0,0,1,0,1,2
"STEAP3",0,2,0,0,0,0,2
"STIL",0,1,0,0,1,0,2
"STK10",0,0,0,1,1,0,2
"STK17B",0,1,0,1,0,0,2
"STK33",0,1,0,0,1,0,2
"STUB1",0,2,0,0,0,0,2
"SUGT1",0,1,0,0,0,1,2
"SULT1E1",0,2,0,0,0,0,2
"SYMPK",0,2,0,0,0,0,2
"SYT13",0,0,0,2,0,0,2
"TAB3",0,0,0,2,0,0,2
"TACR1",1,0,0,0,1,0,2
"TAF1B",0,1,0,1,0,0,2
"TAX1BP1",0,0,0,2,0,0,2
"TBX4",1,0,0,0,1,0,2
"TCL1A",0,1,0,1,0,0,2
"TDRD1",1,0,0,1,0,0,2
"TDRD5",1,0,0,1,0,0,2
"TET3",0,1,0,1,0,0,2
"TFAP2E",0,2,0,0,0,0,2
"THAP11",0,1,0,1,0,0,2
"THBS2",0,1,0,0,1,0,2
"THRB",0,0,1,1,0,0,2
"THSD1",0,1,1,0,0,0,2
"TIPIN",0,2,0,0,0,0,2
"TLE4",0,2,0,0,0,0,2
"TMC1",0,0,0,0,0,2,2
"TMEM25",0,1,0,0,0,1,2
"TMPRSS11A",0,0,2,0,0,0,2
"TMPRSS2",0,1,0,0,1,0,2
"TNFAIP6",0,0,1,0,0,1,2
"TNFRSF11A",0,1,0,1,0,0,2
"TNFRSF17",0,1,0,1,0,0,2
"TNFRSF19",0,2,0,0,0,0,2
"TNFSF13",0,2,0,0,0,0,2
"TNFSF13B",0,0,1,1,0,0,2
"TNFSF18",0,1,0,1,0,0,2
"TNIP1",0,0,2,0,0,0,2
"TNNT1",1,0,0,0,1,0,2
"TNP1",0,1,1,0,0,0,2
"TOM1L1",0,2,0,0,0,0,2
"TOMM20",1,1,0,0,0,0,2
"TOPBP1",0,1,0,0,1,0,2
"TOX3",0,0,0,0,1,1,2
"TP53I11",0,0,0,2,0,0,2
"TPD52L2",0,0,0,1,1,0,2
"TPH1",0,1,0,0,1,0,2
"TPM4",0,0,2,0,0,0,2
"TPTE",0,1,0,1,0,0,2
"TRAC",0,0,0,0,0,2,2
"TRAF4",0,0,0,0,1,1,2
"TRAK2",0,0,1,0,0,1,2
"TRAV10",0,0,0,1,0,1,2
"TREM1",0,0,0,2,0,0,2
"TRIP10",0,0,0,2,0,0,2
"TROAP",0,0,0,2,0,0,2
"TRPA1",0,0,0,0,2,0,2
"TRPC3",0,0,1,0,0,1,2
"TRPM1",0,1,0,0,1,0,2
"TRPM4",0,0,0,0,1,1,2
"TRPS1",0,1,0,0,1,0,2
"TSC1",0,0,0,2,0,0,2
"TSC22D3",0,0,0,1,0,1,2
"TSGA10",0,1,0,1,0,0,2
"TSLP",0,0,0,1,1,0,2
"TSPY1",0,0,0,2,0,0,2
"TSTA3",0,0,0,2,0,0,2
"TTN",0,0,1,0,0,1,2
"TUBB6",0,2,0,0,0,0,2
"U2AF1",0,1,0,0,1,0,2
"UBA3",1,1,0,0,0,0,2
"UBE2I",0,1,0,1,0,0,2
"UBE2M",1,0,1,0,0,0,2
"UBE3A",0,1,0,1,0,0,2
"UBQLN3",0,1,0,1,0,0,2
"UBXN8",0,1,0,1,0,0,2
"UCA1",0,1,1,0,0,0,2
"UCN",0,0,0,2,0,0,2
"UGDH",0,1,0,1,0,0,2
"UGP2",1,1,0,0,0,0,2
"UGT2B11",1,0,0,1,0,0,2
"UGT2B15",0,1,0,1,0,0,2
"UGT2B17",0,1,0,1,0,0,2
"UGT2B7",0,1,0,1,0,0,2
"UIMC1",0,1,0,0,1,0,2
"ULK3",0,1,0,0,1,0,2
"UMOD",0,0,1,0,0,1,2
"UQCRFS1",0,0,0,0,0,2,2
"USP11",0,1,0,0,1,0,2
"USP46",0,2,0,0,0,0,2
"VAMP8",0,1,0,1,0,0,2
"VDAC1",1,0,1,0,0,0,2
"VDAC2",0,0,1,0,1,0,2
"VNN2",0,1,1,0,0,0,2
"VOPP1",0,0,0,0,1,1,2
"VPS13A",0,1,0,0,0,1,2
"VPS13B",0,1,0,0,0,1,2
"VPS13C",0,1,0,0,0,1,2
"VPS33A",0,1,0,0,0,1,2
"VPS35",0,1,0,0,0,1,2
"VPS37B",0,1,0,0,0,1,2
"VPS37D",0,1,0,0,0,1,2
"VPS41",0,1,0,0,0,1,2
"VPS4A",0,0,0,2,0,0,2
"VPS54",0,1,0,0,0,1,2
"VTRNA2-1",1,1,0,0,0,0,2
"WARS",0,1,0,0,1,0,2
"WDHD1",0,1,1,0,0,0,2
"WDR5",0,0,0,1,1,0,2
"WFDC1",0,0,0,1,0,1,2
"WNT7A",0,0,0,0,2,0,2
"XAB2",0,0,0,1,0,1,2
"XG",0,1,0,0,0,1,2
"XIST",0,1,0,1,0,0,2
"XPO5",0,1,0,0,0,1,2
"XRCC2",0,2,0,0,0,0,2
"YWHAB",0,1,0,0,0,1,2
"ZBP1",0,0,0,2,0,0,2
"ZBTB17",0,0,1,1,0,0,2
"ZBTB2",0,1,0,0,0,1,2
"ZMIZ1",0,1,0,1,0,0,2
"ZNF208",0,0,1,0,0,1,2
"ZNF24",0,0,0,2,0,0,2
"ZNF267",0,0,0,2,0,0,2
"ZNF395",0,0,0,2,0,0,2
"ZNF750",0,0,2,0,0,0,2
"ZNRF3",0,2,0,0,0,0,2
"7SK",0,0,0,0,0,1,1
"AAAS",0,0,0,1,0,0,1
"AAMP",0,1,0,0,0,0,1
"AARS",0,0,0,0,0,1,1
"AATF",0,1,0,0,0,0,1
"ABCA10",0,1,0,0,0,0,1
"ABCA13",0,1,0,0,0,0,1
"ABCA6",0,1,0,0,0,0,1
"ABCA8",0,1,0,0,0,0,1
"ABCA9",0,1,0,0,0,0,1
"ABCB9",0,1,0,0,0,0,1
"ABCD1",0,1,0,0,0,0,1
"ABCD4",0,1,0,0,0,0,1
"ABCF1",0,1,0,0,0,0,1
"ABI1",0,0,0,0,0,1,1
"ABI2",0,0,0,0,0,1,1
"ABI3",0,1,0,0,0,0,1
"ACAP2",0,0,1,0,0,0,1
"ACAT2",0,1,0,0,0,0,1
"ACO1",0,1,0,0,0,0,1
"ACOX2",0,0,0,1,0,0,1
"ACOX3",0,0,0,1,0,0,1
"ACP1",0,1,0,0,0,0,1
"ACP6",0,0,1,0,0,0,1
"ACRBP",0,1,0,0,0,0,1
"ACSS1",0,0,0,1,0,0,1
"ACTA2",0,0,1,0,0,0,1
"ACVRL1",0,0,0,0,1,0,1
"ADAM19",0,1,0,0,0,0,1
"ADAM21",0,0,0,1,0,0,1
"ADAM29",0,0,0,0,0,1,1
"ADAM33",0,0,0,0,0,1,1
"ADAMTS17",0,1,0,0,0,0,1
"ADAMTS19",0,1,0,0,0,0,1
"ADAMTS4",0,0,0,1,0,0,1
"ADAMTS5",0,0,0,1,0,0,1
"ADAMTSL3",0,1,0,0,0,0,1
"ADCY2",0,1,0,0,0,0,1
"ADCY3",0,0,0,0,0,1,1
"ADCY5",0,1,0,0,0,0,1
"ADCY9",0,1,0,0,0,0,1
"ADHFE1",0,1,0,0,0,0,1
"ADI1",0,0,0,1,0,0,1
"ADRB3",1,0,0,0,0,0,1
"ADSL",0,1,0,0,0,0,1
"AEN",0,1,0,0,0,0,1
"AFF3",0,0,0,0,0,1,1
"AGGF1",0,1,0,0,0,0,1
"AGK",0,1,0,0,0,0,1
"AGPAT2",0,1,0,0,0,0,1
"AHNAK",0,0,0,0,1,0,1
"AIF1",0,0,1,0,0,0,1
"AJAP1",0,0,0,0,0,1,1
"AK3",0,1,0,0,0,0,1
"AKAP4",0,0,1,0,0,0,1
"AKAP7",0,1,0,0,0,0,1
"AKAP9",0,1,0,0,0,0,1
"AKIP1",0,0,1,0,0,0,1
"AKR1A1",0,0,0,0,1,0,1
"ALAS2",0,0,0,1,0,0,1
"ALDH6A1",0,1,0,0,0,0,1
"ALKBH2",0,1,0,0,0,0,1
"ALKBH3",0,1,0,0,0,0,1
"AMELX",0,1,0,0,0,0,1
"AMELY",0,0,0,1,0,0,1
"AMH",0,1,0,0,0,0,1
"AMOT",0,1,0,0,0,0,1
"AMPD2",0,0,0,1,0,0,1
"AMPD3",0,0,0,1,0,0,1
"AMPH",0,0,0,0,0,1,1
"AMT",0,0,0,0,0,1,1
"ANAPC11",0,0,0,1,0,0,1
"ANGPTL3",0,0,1,0,0,0,1
"ANK1",0,1,0,0,0,0,1
"ANKRD12",0,0,0,0,0,1,1
"ANKRD17",0,1,0,0,0,0,1
"ANKRD46",0,0,0,0,0,1,1
"ANKS1A",0,1,0,0,0,0,1
"ANO5",0,0,0,0,0,1,1
"ANP32A",0,0,0,0,1,0,1
"ANXA13",1,0,0,0,0,0,1
"ANXA6",0,0,0,0,0,1,1
"APCDD1",0,1,0,0,0,0,1
"APLP1",0,0,0,0,0,1,1
"APMAP",0,1,0,0,0,0,1
"APOA1BP",0,0,0,1,0,0,1
"APOBEC3A",0,0,0,1,0,0,1
"APOBEC3H",0,0,0,1,0,0,1
"APOC4",0,1,0,0,0,0,1
"APOH",0,1,0,0,0,0,1
"APOL1",0,1,0,0,0,0,1
"APOO",0,0,0,1,0,0,1
"AQP4",0,0,0,0,0,1,1
"ARAP3",0,0,0,0,0,1,1
"ARFGAP1",0,1,0,0,0,0,1
"ARHGAP10",0,0,0,0,1,0,1
"ARHGAP11A",0,1,0,0,0,0,1
"ARHGAP12",0,0,0,0,1,0,1
"ARHGAP15",0,0,0,0,1,0,1
"ARHGAP17",0,0,0,0,1,0,1
"ARHGAP18",0,0,0,0,1,0,1
"ARHGAP19",0,0,0,0,1,0,1
"ARHGAP20",0,0,0,0,1,0,1
"ARHGAP22",0,0,0,0,1,0,1
"ARHGAP25",0,0,0,0,1,0,1
"ARHGAP27",0,0,0,0,1,0,1
"ARHGEF12",0,1,0,0,0,0,1
"ARHGEF17",0,1,0,0,0,0,1
"ARHGEF19",0,0,0,1,0,0,1
"ARHGEF6",0,0,0,0,0,1,1
"ARID3A",0,0,0,0,0,1,1
"ARID3B",0,0,0,0,0,1,1
"ARID3C",0,0,0,0,0,1,1
"ARID5B",0,0,0,0,0,1,1
"ARL6IP5",0,0,0,0,0,1,1
"ARMC10",0,0,0,1,0,0,1
"ARNTL2",0,1,0,0,0,0,1
"ARPC1A",0,0,1,0,0,0,1
"ARPC2",0,0,0,0,1,0,1
"ART3",0,0,0,1,0,0,1
"AS3MT",0,0,0,1,0,0,1
"ASAP3",0,0,0,1,0,0,1
"ASF1A",0,0,0,1,0,0,1
"ASH1L",0,0,0,1,0,0,1
"ASPA",0,0,1,0,0,0,1
"ASPN",0,0,0,0,0,1,1
"ASTE1",0,0,0,1,0,0,1
"ATAT1",0,0,0,0,1,0,1
"ATF7",0,0,0,1,0,0,1
"ATG4C",0,0,0,1,0,0,1
"ATN1",0,0,0,0,0,1,1
"ATP11A",0,1,0,0,0,0,1
"ATP1B1",0,1,0,0,0,0,1
"ATP5C1",0,1,0,0,0,0,1
"ATP5F1",0,0,0,1,0,0,1
"ATP5J",0,1,0,0,0,0,1
"ATP6V0A1",0,1,0,0,0,0,1
"AURKC",0,1,0,0,0,0,1
"AVL9",0,1,0,0,0,0,1
"AVP",0,0,0,1,0,0,1
"AVPR1B",0,1,0,0,0,0,1
"B3GNT6",0,0,0,0,1,0,1
"B4GALT3",0,1,0,0,0,0,1
"BAAT",0,0,0,1,0,0,1
"BACE1",0,1,0,0,0,0,1
"BACH2",0,1,0,0,0,0,1
"BAMBI",0,0,0,1,0,0,1
"BANF1",0,0,1,0,0,0,1
"BCAP31",0,1,0,0,0,0,1
"BCAS1",0,1,0,0,0,0,1
"BCAS4",0,0,0,0,0,1,1
"BCCIP",0,1,0,0,0,0,1
"BCHE",0,1,0,0,0,0,1
"BCL2L15",0,1,0,0,0,0,1
"BCL7A",0,0,0,0,0,1,1
"BCL9",0,0,1,0,0,0,1
"BET1",0,0,0,1,0,0,1
"BFAR",0,1,0,0,0,0,1
"BHLHB9",0,1,0,0,0,0,1
"BHMT2",0,1,0,0,0,0,1
"BLCAP",0,1,0,0,0,0,1
"BLK",0,1,0,0,0,0,1
"BMP5",0,0,0,0,1,0,1
"BMP8A",0,0,1,0,0,0,1
"BNIP1",0,0,0,1,0,0,1
"BRD2",0,1,0,0,0,0,1
"BRD3",0,0,0,1,0,0,1
"BRDT",0,1,0,0,0,0,1
"BRF1",0,1,0,0,0,0,1
"BRI3",0,1,0,0,0,0,1
"BTBD3",0,1,0,0,0,0,1
"BTG1",0,0,1,0,0,0,1
"BTN2A1",0,1,0,0,0,0,1
"BUD31",0,0,0,1,0,0,1
"BYSL",0,0,0,1,0,0,1
"C11orf31",0,1,0,0,0,0,1
"C14orf166",0,0,0,0,1,0,1
"C16orf62",0,0,0,1,0,0,1
"C1orf61",0,0,0,1,0,0,1
"C1QTNF6",0,0,0,1,0,0,1
"C1S",0,1,0,0,0,0,1
"C20orf24",0,1,0,0,0,0,1
"C3orf35",0,1,0,0,0,0,1
"C9orf50",0,1,0,0,0,0,1
"CA14",0,1,0,0,0,0,1
"CAB39",0,1,0,0,0,0,1
"CACNA2D1",0,0,0,0,0,1,1
"CACNA2D2",0,0,0,0,0,1,1
"CACNA2D4",0,0,0,0,0,1,1
"CALCA",0,0,0,0,0,1,1
"CALD1",0,0,0,0,0,1,1
"CAMK2G",0,1,0,0,0,0,1
"CAMK2N1",0,0,0,1,0,0,1
"CAP2",0,0,0,1,0,0,1
"CAPZB",0,0,0,1,0,0,1
"CARM1",0,0,0,1,0,0,1
"CARS",0,0,1,0,0,0,1
"CASC2",0,0,1,0,0,0,1
"CASC3",0,0,0,0,0,1,1
"CASC5",0,1,0,0,0,0,1
"CASP12",0,1,0,0,0,0,1
"CASP2",0,1,0,0,0,0,1
"CASZ1",0,0,0,0,0,1,1
"CBLN1",0,1,0,0,0,0,1
"CBLN2",0,1,0,0,0,0,1
"CBLN4",0,1,0,0,0,0,1
"CBX1",0,0,0,1,0,0,1
"CCAR1",0,0,0,1,0,0,1
"CCAT1",0,0,0,0,0,1,1
"CCDC134",0,0,0,0,0,1,1
"CCDC158",0,0,0,1,0,0,1
"CCDC26",0,1,0,0,0,0,1
"CCDC62",0,0,0,0,0,1,1
"CCDC67",0,0,0,0,0,1,1
"CCL11",0,1,0,0,0,0,1
"CCL14",0,0,0,1,0,0,1
"CCL23",0,0,0,1,0,0,1
"CCL27",0,1,0,0,0,0,1
"CCNF",0,0,0,1,0,0,1
"CCNL1",0,0,0,1,0,0,1
"CCNY",0,0,0,1,0,0,1
"CCSER1",0,0,0,0,1,0,1
"CCT4",0,0,0,0,0,1,1
"CD1C",0,0,1,0,0,0,1
"CD200R1",0,1,0,0,0,0,1
"CD244",0,1,0,0,0,0,1
"CD52",0,1,0,0,0,0,1
"CDC14B",0,0,0,1,0,0,1
"CDC42BPA",0,0,0,0,1,0,1
"CDC42BPB",0,1,0,0,0,0,1
"CDC42SE1",0,0,0,0,0,1,1
"CDC45",0,1,0,0,0,0,1
"CDC5L",0,1,0,0,0,0,1
"CDCA3",0,0,1,0,0,0,1
"CDCA7L",0,0,0,1,0,0,1
"CDH12",0,1,0,0,0,0,1
"CDH15",0,0,0,1,0,0,1
"CDH4",0,0,0,0,0,1,1
"CDHR2",0,1,0,0,0,0,1
"CDHR5",0,1,0,0,0,0,1
"CDK11A",0,0,0,1,0,0,1
"CDK19",0,1,0,0,0,0,1
"CDKL1",0,0,0,0,0,1,1
"CDON",0,1,0,0,0,0,1
"CDS2",0,1,0,0,0,0,1
"CDX4",0,0,1,0,0,0,1
"CEACAM7",0,1,0,0,0,0,1
"CEBPG",0,0,0,1,0,0,1
"CENPH",0,0,0,0,0,1,1
"CEP135",0,1,0,0,0,0,1
"CERS2",0,0,0,1,0,0,1
"CERS5",0,1,0,0,0,0,1
"CES3",0,1,0,0,0,0,1
"CETN1",0,0,0,0,1,0,1
"CETN2",0,0,0,0,1,0,1
"CHAF1A",0,1,0,0,0,0,1
"CHAT",0,1,0,0,0,0,1
"CHIT1",0,0,0,1,0,0,1
"CHMP4C",0,1,0,0,0,0,1
"CHMP7",0,0,0,0,0,1,1
"CHP2",0,0,0,1,0,0,1
"CHRM2",0,0,0,0,0,1,1
"CHRNA5",0,0,0,0,0,1,1
"CHRNB4",0,1,0,0,0,0,1
"CHRNE",0,0,0,0,0,1,1
"CHST2",0,0,1,0,0,0,1
"CIDEB",0,1,0,0,0,0,1
"CKAP4",1,0,0,0,0,0,1
"CKAP5",0,0,1,0,0,0,1
"CLCA1",0,1,0,0,0,0,1
"CLCA2",0,1,0,0,0,0,1
"CLCA4",0,1,0,0,0,0,1
"CLCN2",0,1,0,0,0,0,1
"CLCN4",0,1,0,0,0,0,1
"CLDN12",0,1,0,0,0,0,1
"CLEC11A",0,1,0,0,0,0,1
"CLIC3",1,0,0,0,0,0,1
"CLIP2",0,1,0,0,0,0,1
"CLK4",0,1,0,0,0,0,1
"CLN3",0,1,0,0,0,0,1
"CLPP",0,0,0,0,0,1,1
"CLSTN1",0,1,0,0,0,0,1
"CMAS",0,0,0,0,1,0,1
"CMTM2",0,1,0,0,0,0,1
"CMTM4",0,1,0,0,0,0,1
"CMTM5",0,0,0,1,0,0,1
"CNOT1",0,0,0,1,0,0,1
"CNOT7",0,1,0,0,0,0,1
"CNST",0,0,0,1,0,0,1
"CNTF",0,0,0,1,0,0,1
"CNTFR",0,0,0,1,0,0,1
"COL10A1",0,0,1,0,0,0,1
"COL13A1",0,1,0,0,0,0,1
"COL4A4",0,0,1,0,0,0,1
"COL5A2",0,1,0,0,0,0,1
"COL6A1",0,1,0,0,0,0,1
"COL6A2",0,0,0,1,0,0,1
"COL7A1",0,0,0,0,1,0,1
"COL9A2",0,0,0,0,0,1,1
"COLCA2",0,1,0,0,0,0,1
"COMMD7",0,0,0,1,0,0,1
"COMP",0,0,0,0,1,0,1
"COPB2",0,0,0,0,1,0,1
"CORO1B",0,0,0,0,0,1,1
"CORO2A",0,1,0,0,0,0,1
"COX4I1",0,0,1,0,0,0,1
"COX6C",0,0,1,0,0,0,1
"COX7C",0,1,0,0,0,0,1
"CPEB1",0,0,0,0,0,1,1
"CPEB3",0,1,0,0,0,0,1
"CPSF6",0,1,0,0,0,0,1
"CPT1A",0,1,0,0,0,0,1
"CPT2",0,1,0,0,0,0,1
"CRABP2",0,0,0,0,0,1,1
"CRADD",0,0,0,0,0,1,1
"CRCT1",0,0,1,0,0,0,1
"CRELD2",0,0,0,1,0,0,1
"CRIM1",0,0,0,0,0,1,1
"CRIPT",0,0,0,0,0,1,1
"CRNDE",1,0,0,0,0,0,1
"CROT",0,0,0,1,0,0,1
"CSMD3",0,1,0,0,0,0,1
"CSN3",0,1,0,0,0,0,1
"CSNK2A1",0,1,0,0,0,0,1
"CSNK2B",0,0,0,1,0,0,1
"CSRP2",0,0,0,1,0,0,1
"CTDSP1",0,0,0,0,1,0,1
"CTDSPL",0,0,1,0,0,0,1
"CTNNAL1",0,0,1,0,0,0,1
"CTPS2",0,1,0,0,0,0,1
"CTRB1",0,0,0,0,1,0,1
"CTRC",0,0,0,0,1,0,1
"CTSC",0,1,0,0,0,0,1
"CTSH",0,0,0,0,1,0,1
"CTSK",0,1,0,0,0,0,1
"CTSS",0,0,0,1,0,0,1
"CUBN",0,0,0,0,0,1,1
"CUL5",0,0,0,1,0,0,1
"CUL7",0,0,0,0,1,0,1
"CUZD1",0,0,0,0,1,0,1
"CXCL17",0,1,0,0,0,0,1
"CYB5A",0,0,0,0,1,0,1
"CYB5B",0,0,0,1,0,0,1
"CYP26B1",0,0,0,0,0,1,1
"CYP2F1",0,1,0,0,0,0,1
"CYP2U1",0,1,0,0,0,0,1
"CYP39A1",1,0,0,0,0,0,1
"CYP4F2",0,0,0,1,0,0,1
"CYP4V2",0,1,0,0,0,0,1
"DAB1",0,0,0,0,1,0,1
"DAB2",0,0,0,1,0,0,1
"DANCR",0,0,0,1,0,0,1
"DAO",0,1,0,0,0,0,1
"DAPK3",0,0,0,0,0,1,1
"DAZL",0,1,0,0,0,0,1
"DBI",0,1,0,0,0,0,1
"DCAF12L2",0,1,0,0,0,0,1
"DCBLD2",0,0,0,0,0,1,1
"DCP2",0,1,0,0,0,0,1
"DCTD",1,0,0,0,0,0,1
"DDAH1",0,0,0,0,0,1,1
"DDN",0,1,0,0,0,0,1
"DDX21",0,1,0,0,0,0,1
"DDX28",0,1,0,0,0,0,1
"DDX3Y",0,0,0,1,0,0,1
"DDX43",0,0,0,0,1,0,1
"DDX46",0,0,1,0,0,0,1
"DEDD2",0,0,0,1,0,0,1
"DEFB1",0,0,0,0,0,1,1
"DENND2D",0,0,0,1,0,0,1
"DENND5A",0,1,0,0,0,0,1
"DEXI",0,1,0,0,0,0,1
"DGAT1",0,0,0,1,0,0,1
"DGCR6L",0,0,0,0,0,1,1
"DGKA",0,0,0,0,1,0,1
"DGKE",0,1,0,0,0,0,1
"DGKG",0,0,1,0,0,0,1
"DHRS9",0,0,0,0,0,1,1
"DHX32",0,1,0,0,0,0,1
"DHX36",0,1,0,0,0,0,1
"DLX2",0,0,0,0,0,1,1
"DLX6",0,0,1,0,0,0,1
"DMRT1",0,0,0,0,0,1,1
"DMRT2",0,0,1,0,0,0,1
"DNAH9",0,0,1,0,0,0,1
"DNAJB1",0,0,0,0,0,1,1
"DNAJB6",0,0,1,0,0,0,1
"DNAJB8",0,1,0,0,0,0,1
"DNAJB9",1,0,0,0,0,0,1
"DNAJC12",0,0,0,1,0,0,1
"DNAJC3",0,0,0,0,0,1,1
"DNAJC6",0,1,0,0,0,0,1
"DNMBP",0,0,0,1,0,0,1
"DNMT3L",0,0,0,0,0,1,1
"DOCK1",0,0,0,0,0,1,1
"DOCK2",0,0,1,0,0,0,1
"DOCK5",0,0,0,0,0,1,1
"DPAGT1",0,0,0,1,0,0,1
"DPM1",0,0,0,0,1,0,1
"DPP10",0,1,0,0,0,0,1
"DPPA2",0,1,0,0,0,0,1
"DPY19L1",0,1,0,0,0,0,1
"DPYSL2",0,0,0,0,0,1,1
"DPYSL3",0,0,0,1,0,0,1
"DRAM2",0,0,0,0,0,1,1
"DSG3",0,0,0,0,1,0,1
"DTNB",0,0,0,1,0,0,1
"DTX3",0,1,0,0,0,0,1
"DTYMK",0,0,0,0,0,1,1
"DUSP10",0,1,0,0,0,0,1
"DUSP11",0,1,0,0,0,0,1
"DUSP21",0,0,0,1,0,0,1
"DUSP7",0,1,0,0,0,0,1
"DUSP9",0,0,0,1,0,0,1
"DYNC1I1",0,0,0,1,0,0,1
"DYNLT3",0,0,1,0,0,0,1
"DYX1C1",0,1,0,0,0,0,1
"E2F6",0,0,0,1,0,0,1
"E2F7",0,1,0,0,0,0,1
"E4F1",0,0,0,1,0,0,1
"EAF1",0,0,0,1,0,0,1
"EBI3",0,1,0,0,0,0,1
"ECE2",1,0,0,0,0,0,1
"ECH1",0,0,0,0,0,1,1
"EDEM1",0,0,0,1,0,0,1
"EGR4",0,0,0,0,1,0,1
"EHMT1",0,1,0,0,0,0,1
"EIF2B5",0,0,0,0,1,0,1
"EIF3B",0,1,0,0,0,0,1
"EIF3F",0,1,0,0,0,0,1
"EIF3M",0,1,0,0,0,0,1
"EIF4EBP2",0,1,0,0,0,0,1
"EIF4EBP3",0,1,0,0,0,0,1
"EIF4G2",0,0,0,0,0,1,1
"EIF4H",0,1,0,0,0,0,1
"ELAVL4",0,1,0,0,0,0,1
"ELF2",0,1,0,0,0,0,1
"EMILIN2",0,0,1,0,0,0,1
"EMP3",0,0,1,0,0,0,1
"EMX2",0,0,0,0,0,1,1
"ENAM",0,1,0,0,0,0,1
"ENO3",0,0,0,1,0,0,1
"EP400",0,0,0,0,0,1,1
"EPB41",0,0,0,1,0,0,1
"EPHA1",0,1,0,0,0,0,1
"EPHA10",0,1,0,0,0,0,1
"EPHA8",0,1,0,0,0,0,1
"EPHX2",0,0,1,0,0,0,1
"EPN3",0,0,0,0,1,0,1
"EPPK1",1,0,0,0,0,0,1
"EPRS",0,1,0,0,0,0,1
"ERBIN",1,0,0,0,0,0,1
"ESRP2",0,0,0,1,0,0,1
"ESRRB",0,1,0,0,0,0,1
"ESX1",0,1,0,0,0,0,1
"ETHE1",0,0,0,0,0,1,1
"ETNK1",0,0,0,0,0,1,1
"ETV3",0,1,0,0,0,0,1
"EVI2B",0,1,0,0,0,0,1
"EWSR1",0,1,0,0,0,0,1
"EXOC1",0,0,0,0,1,0,1
"EXOSC4",0,1,0,0,0,0,1
"EXTL1",0,1,0,0,0,0,1
"EXTL3",0,1,0,0,0,0,1
"EYA1",0,0,0,0,0,1,1
"EYA2",0,1,0,0,0,0,1
"F2",0,0,0,1,0,0,1
"FAIM",0,0,1,0,0,0,1
"FAIM2",0,1,0,0,0,0,1
"FAM101A",0,1,0,0,0,0,1
"FAM120A",0,0,0,0,0,1,1
"FAM172A",0,0,0,1,0,0,1
"FAM189B",0,0,0,1,0,0,1
"FAM19A5",1,0,0,0,0,0,1
"FAM3D",0,1,0,0,0,0,1
"FAM43B",0,0,0,1,0,0,1
"FAM60A",0,0,1,0,0,0,1
"FAM83H",0,1,0,0,0,0,1
"FAM9C",0,0,0,1,0,0,1
"FANCM",0,1,0,0,0,0,1
"FAU",0,0,0,1,0,0,1
"FBLN2",0,0,0,0,1,0,1
"FBLN5",0,0,0,0,1,0,1
"FBP2",0,0,0,0,0,1,1
"FBXL19",0,0,1,0,0,0,1
"FBXO31",0,0,0,1,0,0,1
"FCER2",0,0,0,0,0,1,1
"FCN2",0,0,0,1,0,0,1
"FCRL3",0,0,0,0,0,1,1
"FDPS",0,0,0,1,0,0,1
"FERMT3",0,1,0,0,0,0,1
"FEZ1",0,0,0,0,0,1,1
"FEZF1",0,0,0,0,0,1,1
"FHDC1",0,0,0,0,1,0,1
"FHL3",0,0,0,1,0,0,1
"FHOD3",0,0,0,0,1,0,1
"FKBP11",0,0,0,1,0,0,1
"FKBP4",0,1,0,0,0,0,1
"FLOT2",0,1,0,0,0,0,1
"FMO3",0,1,0,0,0,0,1
"FMO4",0,1,0,0,0,0,1
"FMR1",0,1,0,0,0,0,1
"FOXD1",0,0,0,0,1,0,1
"FOXD2",0,0,0,0,1,0,1
"FOXD4",0,0,0,0,1,0,1
"FOXD4L1",0,0,0,0,1,0,1
"FOXD4L3",0,0,0,0,1,0,1
"FOXE3",0,0,0,0,1,0,1
"FOXF2",0,0,0,0,1,0,1
"FOXG1",0,0,0,0,1,0,1
"FOXI1",0,0,0,0,1,0,1
"FOXJ3",0,0,0,0,1,0,1
"FOXK1",0,0,0,0,1,0,1
"FOXL2",0,1,0,0,0,0,1
"FOXN1",0,0,0,0,1,0,1
"FOXN3",0,0,0,0,1,0,1
"FOXN4",0,0,0,0,1,0,1
"FOXP4",0,0,0,0,1,0,1
"FOXR2",0,0,0,0,1,0,1
"FPR3",0,0,0,0,0,1,1
"FRS3",0,0,0,0,0,1,1
"FSHR",0,1,0,0,0,0,1
"FSTL1",0,1,0,0,0,0,1
"FSTL3",0,0,0,1,0,0,1
"FUCA2",0,0,0,0,0,1,1
"FXN",0,1,0,0,0,0,1
"FXR1",0,1,0,0,0,0,1
"FZD9",0,0,0,0,0,1,1
"G6PC2",0,0,0,0,0,1,1
"GABRA1",0,1,0,0,0,0,1
"GABRA2",0,0,1,0,0,0,1
"GABRA3",0,0,0,1,0,0,1
"GALNT1",0,0,0,0,0,1,1
"GALNT13",0,1,0,0,0,0,1
"GALNT4",0,0,0,0,0,1,1
"GALNT8",0,1,0,0,0,0,1
"GALP",0,1,0,0,0,0,1
"GAS5",0,0,0,0,1,0,1
"GAS7",0,0,0,1,0,0,1
"GATA3",0,0,0,0,0,1,1
"GBA",0,0,0,1,0,0,1
"GBA3",0,0,0,1,0,0,1
"GCH1",0,0,1,0,0,0,1
"GCNT3",0,1,0,0,0,0,1
"GDF11",0,1,0,0,0,0,1
"GDF3",0,0,0,1,0,0,1
"GDF9",0,0,0,1,0,0,1
"GDNF",0,1,0,0,0,0,1
"GGA3",0,0,0,1,0,0,1
"GGCT",0,0,1,0,0,0,1
"GGCX",0,0,0,1,0,0,1
"GGH",1,0,0,0,0,0,1
"GGT1",0,0,0,1,0,0,1
"GGT2",0,1,0,0,0,0,1
"GIT2",0,0,0,0,1,0,1
"GJA1P1",0,1,0,0,0,0,1
"GJA4",0,1,0,0,0,0,1
"GJA8",0,1,0,0,0,0,1
"GJA9",0,1,0,0,0,0,1
"GJD2",0,1,0,0,0,0,1
"GLCE",0,1,0,0,0,0,1
"GLDC",0,0,0,1,0,0,1
"GLIPR1",0,1,0,0,0,0,1
"GLIPR2",1,0,0,0,0,0,1
"GLT1D1",0,1,0,0,0,0,1
"GLYATL1",0,0,0,1,0,0,1
"GLYATL2",0,0,0,1,0,0,1
"GMIP",0,0,0,0,1,0,1
"GNA13",0,1,0,0,0,0,1
"GNA14",0,0,0,0,0,1,1
"GNAI3",0,0,0,0,0,1,1
"GNAS-AS1",0,1,0,0,0,0,1
"GNAT1",0,0,0,0,1,0,1
"GNAZ",0,0,0,1,0,0,1
"GNB3",1,0,0,0,0,0,1
"GNB4",0,1,0,0,0,0,1
"GNB5",0,1,0,0,0,0,1
"GNG10",0,0,0,1,0,0,1
"GNL2",0,1,0,0,0,0,1
"GNPDA2",0,1,0,0,0,0,1
"GNS",0,0,0,1,0,0,1
"GOLGA4",0,1,0,0,0,0,1
"GOLGB1",0,0,0,1,0,0,1
"GOLPH3L",0,1,0,0,0,0,1
"GPAM",0,0,0,1,0,0,1
"GPC5",0,0,0,1,0,0,1
"GPR152",0,0,0,0,0,1,1
"GPR160",0,0,0,0,0,1,1
"GPR171",0,0,0,0,0,1,1
"GPR180",0,1,0,0,0,0,1
"GPR35",0,0,0,0,0,1,1
"GPR37",0,0,0,1,0,0,1
"GPR55",1,0,0,0,0,0,1
"GPR65",0,1,0,0,0,0,1
"GPR78",0,0,0,1,0,0,1
"GPR87",0,0,0,1,0,0,1
"GPSM1",0,0,1,0,0,0,1
"GPSM2",0,1,0,0,0,0,1
"GPX7",0,0,1,0,0,0,1
"GRAMD4",0,0,0,1,0,0,1
"GRAP2",0,0,0,1,0,0,1
"GRHPR",0,0,0,1,0,0,1
"GRIA3",0,0,0,0,1,0,1
"GRIK1",0,0,0,1,0,0,1
"GRM2",0,1,0,0,0,0,1
"GRM3",0,0,1,0,0,0,1
"GRWD1",0,1,0,0,0,0,1
"GSDMD",0,0,0,0,0,1,1
"GSG1L",0,1,0,0,0,0,1
"GSTM4",0,1,0,0,0,0,1
"GSTZ1",0,0,0,0,0,1,1
"GTF2H2",0,0,0,0,1,0,1
"GTF2H5",0,1,0,0,0,0,1
"GZMA",0,1,0,0,0,0,1
"GZMB",0,0,1,0,0,0,1
"GZMH",0,0,0,1,0,0,1
"H2AFZ",0,1,0,0,0,0,1
"HABP4",0,1,0,0,0,0,1
"HADH",0,0,0,1,0,0,1
"HAT1",0,1,0,0,0,0,1
"HAVCR1",0,0,0,1,0,0,1
"HAX1",0,1,0,0,0,0,1
"HBA1",0,0,0,0,1,0,1
"HBA2",1,0,0,0,0,0,1
"HBP1",0,1,0,0,0,0,1
"HCP5",0,0,0,1,0,0,1
"HDLBP",0,0,0,1,0,0,1
"HELLS",0,0,0,0,0,1,1
"HEPHL1",0,1,0,0,0,0,1
"HERC1",0,1,0,0,0,0,1
"HERPUD1",0,0,0,1,0,0,1
"HEXB",0,1,0,0,0,0,1
"HHEX",0,0,0,1,0,0,1
"HHIPL1",0,0,0,0,1,0,1
"HIF3A",0,0,0,1,0,0,1
"HIP1",0,1,0,0,0,0,1
"HIP1R",0,1,0,0,0,0,1
"HIST1H2BF",0,0,0,1,0,0,1
"HIST1H3D",0,0,0,0,0,1,1
"HIST2H2BE",0,0,0,0,0,1,1
"HIVEP2",0,1,0,0,0,0,1
"HLA-DPA1",0,0,0,1,0,0,1
"HLA-F",0,0,0,1,0,0,1
"HLA-G",0,0,0,1,0,0,1
"HLX",0,0,0,0,0,1,1
"HMBOX1",0,0,0,1,0,0,1
"HMGCS1",0,0,0,1,0,0,1
"HMGN1",0,0,0,1,0,0,1
"HMGN2",0,0,0,1,0,0,1
"HMGN3",0,0,0,1,0,0,1
"HMMR",0,1,0,0,0,0,1
"HMX2",0,1,0,0,0,0,1
"HNF1A-AS1",0,0,1,0,0,0,1
"HNRNPA0",0,0,0,0,0,1,1
"HNRNPC",0,0,0,0,1,0,1
"HNRNPU",0,0,0,1,0,0,1
"HOMER1",1,0,0,0,0,0,1
"HOMER3",0,0,1,0,0,0,1
"HORMAD1",0,0,0,0,0,1,1
"HOXA11-AS",1,0,0,0,0,0,1
"HOXA4",0,1,0,0,0,0,1
"HOXB1",0,0,0,0,1,0,1
"HOXB2",0,0,0,0,1,0,1
"HOXB4",1,0,0,0,0,0,1
"HOXC4",0,0,1,0,0,0,1
"HOXC9",0,0,1,0,0,0,1
"HOXD11",0,0,0,0,0,1,1
"HOXD4",0,0,0,0,0,1,1
"HPCAL1",0,0,0,0,1,0,1
"HPD",0,0,0,1,0,0,1
"HPN",0,0,0,0,0,1,1
"HRASLS2",0,1,0,0,0,0,1
"HRC",0,0,0,1,0,0,1
"HRH3",1,0,0,0,0,0,1
"HS3ST4",0,1,0,0,0,0,1
"HS6ST2",0,1,0,0,0,0,1
"HSPA14",0,1,0,0,0,0,1
"HSPA2",0,0,0,0,1,0,1
"HSPA4",0,0,0,1,0,0,1
"HSPA4L",0,0,0,1,0,0,1
"HSPA6",0,1,0,0,0,0,1
"HSPB6",0,0,0,1,0,0,1
"HTR2B",0,0,0,1,0,0,1
"HTT",0,1,0,0,0,0,1
"HUNK",0,1,0,0,0,0,1
"HYAL2",0,0,0,0,0,1,1
"HYOU1",0,0,0,1,0,0,1
"IARS",0,1,0,0,0,0,1
"IARS2",0,1,0,0,0,0,1
"ICA1",0,0,0,0,1,0,1
"ICAM2",0,0,0,0,1,0,1
"ICAM5",0,0,1,0,0,0,1
"ICMT",0,1,0,0,0,0,1
"IDH3B",0,0,0,1,0,0,1
"IDO1",0,0,0,0,1,0,1
"IER5",0,1,0,0,0,0,1
"IER5L",0,1,0,0,0,0,1
"IFI27",0,0,0,0,0,1,1
"IFITM2",0,1,0,0,0,0,1
"IFNL4",0,0,0,1,0,0,1
"IGFBP5",0,0,0,0,1,0,1
"IGHA1",0,0,0,0,0,1,1
"IGHG1",0,0,0,0,1,0,1
"IGHMBP2",0,0,1,0,0,0,1
"IK",0,1,0,0,0,0,1
"IKBKG",0,0,0,1,0,0,1
"IKZF1",0,0,0,0,0,1,1
"IL17B",0,0,0,0,0,1,1
"IL17C",0,1,0,0,0,0,1
"IL17RA",0,0,0,0,0,1,1
"IL1RAP",0,0,0,1,0,0,1
"IL22RA2",0,0,1,0,0,0,1
"IL27",0,0,0,1,0,0,1
"IL2RG",0,1,0,0,0,0,1
"IL5",0,0,0,0,0,1,1
"ILF2",0,0,0,0,1,0,1
"ILF3",0,0,0,0,1,0,1
"INF2",0,0,0,0,0,1,1
"INHA",0,0,0,1,0,0,1
"INHBE",0,0,0,1,0,0,1
"INPP1",0,1,0,0,0,0,1
"INSL5",0,1,0,0,0,0,1
"INSM1",0,1,0,0,0,0,1
"INTS3",0,0,0,1,0,0,1
"IP6K2",0,1,0,0,0,0,1
"IPO8",0,1,0,0,0,0,1
"IQGAP3",0,0,0,1,0,0,1
"IRF3",0,1,0,0,0,0,1
"IRF8",0,1,0,0,0,0,1
"IRX2",0,0,0,0,0,1,1
"IRX3",1,0,0,0,0,0,1
"IRX5",0,1,0,0,0,0,1
"ITCH",0,1,0,0,0,0,1
"ITGAM",0,1,0,0,0,0,1
"ITGB3BP",0,1,0,0,0,0,1
"ITGB7",0,1,0,0,0,0,1
"ITGB8",0,0,0,1,0,0,1
"ITIH1",1,0,0,0,0,0,1
"ITIH2",0,0,0,1,0,0,1
"ITIH4",0,0,0,1,0,0,1
"ITPKC",0,1,0,0,0,0,1
"ITPR2",0,1,0,0,0,0,1
"JAZF1",0,1,0,0,0,0,1
"JMJD6",0,1,0,0,0,0,1
"KANK1",0,0,1,0,0,0,1
"KAT8",0,0,1,0,0,0,1
"KCNA1",0,1,0,0,0,0,1
"KCNA4",0,0,0,0,0,1,1
"KCNJ10",0,0,0,1,0,0,1
"KCNJ11",0,1,0,0,0,0,1
"KCNJ8",0,0,1,0,0,0,1
"KCNRG",0,0,0,1,0,0,1
"KCTD15",0,1,0,0,0,0,1
"KCTD2",0,1,0,0,0,0,1
"KDM2B",0,0,0,0,1,0,1
"KDM5B",0,0,1,0,0,0,1
"KDM5C",0,0,0,0,1,0,1
"KDM6A",0,0,0,0,1,0,1
"KDM6B",0,1,0,0,0,0,1
"KDM8",1,0,0,0,0,0,1
"KHSRP",0,1,0,0,0,0,1
"KIAA0040",0,1,0,0,0,0,1
"KIAA0196",0,1,0,0,0,0,1
"KIAA0753",0,1,0,0,0,0,1
"KIAA1033",0,1,0,0,0,0,1
"KIAA1109",0,0,0,0,0,1,1
"KIAA1456",0,1,0,0,0,0,1
"KIF12",0,0,0,0,1,0,1
"KIF13B",0,1,0,0,0,0,1
"KIF5B",0,1,0,0,0,0,1
"KIR2DL1",0,1,0,0,0,0,1
"KIR2DL4",0,0,0,0,1,0,1
"KLHL11",0,1,0,0,0,0,1
"KLK12",0,0,0,0,0,1,1
"KLK5",0,1,0,0,0,0,1
"KLRG1",0,1,0,0,0,0,1
"KRT2",0,1,0,0,0,0,1
"KRTAP12-3",0,1,0,0,0,0,1
"KSR1",0,0,0,0,1,0,1
"LAMA3",0,0,0,0,0,1,1
"LAMB2",0,0,0,0,0,1,1
"LAMB4",0,1,0,0,0,0,1
"LAMC1",0,0,0,1,0,0,1
"LAMC3",0,1,0,0,0,0,1
"LARP7",0,0,0,0,0,1,1
"LAS1L",0,0,0,0,1,0,1
"LASP1",0,0,1,0,0,0,1
"LDHC",0,0,0,0,0,1,1
"LEMD1",0,1,0,0,0,0,1
"LETM1",0,0,0,1,0,0,1
"LFNG",0,1,0,0,0,0,1
"LHX4",0,0,0,1,0,0,1
"LIG4",0,1,0,0,0,0,1
"LIN9",0,0,0,1,0,0,1
"LINC00152",0,0,0,0,0,1,1
"LINC01554",0,0,1,0,0,0,1
"LIPE",0,0,0,1,0,0,1
"LIPF",0,0,0,0,0,1,1
"LIPI",0,0,0,1,0,0,1
"LITAF",0,0,0,1,0,0,1
"LMAN1",0,1,0,0,0,0,1
"LMCD1",0,0,0,1,0,0,1
"LMO1",0,0,0,0,0,1,1
"LMO3",0,1,0,0,0,0,1
"LMO4",0,1,0,0,0,0,1
"LMO7",0,1,0,0,0,0,1
"LMOD1",0,1,0,0,0,0,1
"LMX1A",0,0,0,0,0,1,1
"LNX2",0,1,0,0,0,0,1
"LOXL3",0,1,0,0,0,0,1
"LPAR4",0,1,0,0,0,0,1
"LPAR6",0,0,0,1,0,0,1
"LPCAT2",0,1,0,0,0,0,1
"LPIN2",0,1,0,0,0,0,1
"LPP",1,0,0,0,0,0,1
"LRAT",0,0,0,1,0,0,1
"LRCH1",0,1,0,0,0,0,1
"LRFN2",0,0,0,1,0,0,1
"LRP2",0,0,0,0,1,0,1
"LRPPRC",0,0,0,0,0,1,1
"LRRC1",0,0,0,1,0,0,1
"LRRC4",0,1,0,0,0,0,1
"LRRFIP1",0,1,0,0,0,0,1
"LSM8",0,0,0,0,1,0,1
"LSP1",0,0,0,0,1,0,1
"LSR",0,1,0,0,0,0,1
"LTA4H",0,1,0,0,0,0,1
"LTK",0,0,0,0,0,1,1
"LYPLAL1",0,1,0,0,0,0,1
"LZTFL1",0,0,0,0,0,1,1
"MACF1",0,0,0,1,0,0,1
"MAFF",0,0,0,1,0,0,1
"MAGED2",0,0,0,0,0,1,1
"MAGEH1",1,0,0,0,0,0,1
"MAGOH",0,1,0,0,0,0,1
"MAML1",0,1,0,0,0,0,1
"MAN2A1",0,0,0,1,0,0,1
"MAN2C1",0,0,1,0,0,0,1
"MANBA",0,1,0,0,0,0,1
"MANF",0,0,0,0,1,0,1
"MAOB",0,1,0,0,0,0,1
"MAP2K6",0,1,0,0,0,0,1
"MAP3K4",1,0,0,0,0,0,1
"MAP3K8",0,1,0,0,0,0,1
"MAP4K2",0,1,0,0,0,0,1
"MAP7",0,0,0,1,0,0,1
"MAPK13",0,1,0,0,0,0,1
"MAPKAPK3",0,1,0,0,0,0,1
"MAPT",0,0,0,0,1,0,1
"MARCKSL1",0,0,1,0,0,0,1
"MARK3",0,0,0,0,0,1,1
"MARVELD1",0,0,0,1,0,0,1
"MATN2",0,0,0,1,0,0,1
"MATR3",0,1,0,0,0,0,1
"MBD3",0,0,0,1,0,0,1
"MC4R",0,1,0,0,0,0,1
"MCM3",0,0,0,1,0,0,1
"MCM9",0,0,0,1,0,0,1
"MCMBP",0,0,0,1,0,0,1
"MCPH1",0,0,0,0,1,0,1
"MCTP1",0,0,0,1,0,0,1
"MCUR1",0,1,0,0,0,0,1
"MECP2",0,0,0,0,0,1,1
"MED23",0,0,0,0,0,1,1
"MEF2B",0,1,0,0,0,0,1
"MEIS1",0,1,0,0,0,0,1
"MEPE",0,1,0,0,0,0,1
"MFAP5",1,0,0,0,0,0,1
"MFF",0,1,0,0,0,0,1
"MFNG",0,0,0,0,0,1,1
"MFSD2A",0,0,0,0,0,1,1
"MGAM",0,1,0,0,0,0,1
"MGAT4A",0,0,0,1,0,0,1
"MGAT4B",0,0,0,1,0,0,1
"MGST1",0,1,0,0,0,0,1
"MICG",0,1,0,0,0,0,1
"MICU2",0,1,0,0,0,0,1
"MIR148B",0,0,0,0,0,1,1
"MIR16-1",0,0,0,1,0,0,1
"MIR185",0,0,0,1,0,0,1
"MIR186",0,1,0,0,0,0,1
"MIR211",0,1,0,0,0,0,1
"MIR216A",0,0,0,1,0,0,1
"MIR30B",0,1,0,0,0,0,1
"MIR326",0,0,1,0,0,0,1
"MIR382",0,0,0,0,0,1,1
"MIR449B",0,1,0,0,0,0,1
"MIR494",0,0,0,1,0,0,1
"MIR503",0,0,0,1,0,0,1
"MIR542",0,1,0,0,0,0,1
"MIR579",0,1,0,0,0,0,1
"MIR602",0,0,0,1,0,0,1
"MIR608",0,1,0,0,0,0,1
"MIR610",0,0,0,0,0,1,1
"MKRN1",0,0,0,0,0,1,1
"MLC1",0,0,0,1,0,0,1
"MLLT10",0,1,0,0,0,0,1
"MLNR",1,0,0,0,0,0,1
"MMD",0,1,0,0,0,0,1
"MMP20",0,1,0,0,0,0,1
"MMP24",0,0,1,0,0,0,1
"MMP26",0,1,0,0,0,0,1
"MMS22L",0,0,1,0,0,0,1
"MORC2",0,0,0,0,0,1,1
"MPL",0,0,0,1,0,0,1
"MPST",0,1,0,0,0,0,1
"MRC2",0,0,0,1,0,0,1
"MRGPRX4",0,1,0,0,0,0,1
"MRO",0,1,0,0,0,0,1
"MRPL19",0,1,0,0,0,0,1
"MRPS31",0,1,0,0,0,0,1
"MS4A1",0,0,0,0,0,1,1
"MSMB",0,0,0,0,0,1,1
"MT-CO3",0,0,0,1,0,0,1
"MT1B",0,1,0,0,0,0,1
"MT1DP",0,1,0,0,0,0,1
"MT1M",0,0,0,1,0,0,1
"MTA3",0,0,0,1,0,0,1
"MTCH2",0,1,0,0,0,0,1
"MTHFD2",0,0,0,1,0,0,1
"MUC20",0,1,0,0,0,0,1
"MUC21",0,0,1,0,0,0,1
"MXD1",0,1,0,0,0,0,1
"MXRA5",0,1,0,0,0,0,1
"MYADM",0,1,0,0,0,0,1
"MYH1",0,1,0,0,0,0,1
"MYH2",0,0,0,1,0,0,1
"MYH6",0,0,1,0,0,0,1
"MYH7",0,0,1,0,0,0,1
"MYL12B",0,0,1,0,0,0,1
"MYL9",0,1,0,0,0,0,1
"MYLK2",0,1,0,0,0,0,1
"MYLK4",0,1,0,0,0,0,1
"MYLKP1",0,1,0,0,0,0,1
"MYO5A",0,0,0,0,0,1,1
"MYO6",0,0,0,0,1,0,1
"MYOM1",0,0,0,1,0,0,1
"MYT1L",0,0,0,0,0,1,1
"NADSYN1",0,1,0,0,0,0,1
"NAE1",1,0,0,0,0,0,1
"NANOS1",0,0,0,1,0,0,1
"NBR1",0,1,0,0,0,0,1
"NCAN",0,1,0,0,0,0,1
"NCAPG",0,0,0,0,1,0,1
"NCAPH2",0,0,0,0,0,1,1
"NCBP1",0,1,0,0,0,0,1
"NCOA4",0,1,0,0,0,0,1
"NDEL1",0,0,0,0,1,0,1
"NDRG3",0,0,0,1,0,0,1
"NDST4",0,1,0,0,0,0,1
"NDUFA9",0,0,0,1,0,0,1
"NDUFAF1",0,0,0,1,0,0,1
"NDUFS8",0,0,0,1,0,0,1
"NEDD1",0,0,0,0,0,1,1
"NEGR1",0,1,0,0,0,0,1
"NEIL3",0,1,0,0,0,0,1
"NEK1",0,1,0,0,0,0,1
"NEK11",0,1,0,0,0,0,1
"NEK4",0,1,0,0,0,0,1
"NEK8",0,0,0,1,0,0,1
"NEK9",0,0,0,0,1,0,1
"NFE2L1",0,0,0,1,0,0,1
"NFE2L3",0,1,0,0,0,0,1
"NFIL3",0,0,1,0,0,0,1
"NFKBIZ",0,0,0,1,0,0,1
"NFX1",0,0,1,0,0,0,1
"NFYC",0,0,0,0,0,1,1
"NGB",0,0,0,1,0,0,1
"NHP2",0,1,0,0,0,0,1
"NHSL1",0,1,0,0,0,0,1
"NIT1",0,0,1,0,0,0,1
"NKX2-8",0,0,0,1,0,0,1
"NLRP6",0,1,0,0,0,0,1
"NLRX1",0,1,0,0,0,0,1
"NMBR",0,1,0,0,0,0,1
"NME4",0,1,0,0,0,0,1
"NME7",0,0,0,1,0,0,1
"NMS",0,0,0,0,0,1,1
"NOL8",0,0,0,0,0,1,1
"NOLC1",0,0,0,1,0,0,1
"NOP14",0,0,0,0,1,0,1
"NOX3",0,1,0,0,0,0,1
"NPC1",0,0,1,0,0,0,1
"NPC2",0,0,0,1,0,0,1
"NPM2",0,1,0,0,0,0,1
"NPNT",0,0,0,0,0,1,1
"NPTX1",0,0,0,0,1,0,1
"NPY1R",1,0,0,0,0,0,1
"NR1D1",0,0,1,0,0,0,1
"NR1D2",0,0,1,0,0,0,1
"NR2E3",0,0,0,0,1,0,1
"NR2F1",0,0,0,1,0,0,1
"NR2F2",0,1,0,0,0,0,1
"NRARP",0,1,0,0,0,0,1
"NRM",0,1,0,0,0,0,1
"NRSN2",0,0,0,1,0,0,1
"NRXN1",0,0,0,1,0,0,1
"NSD1",0,0,0,1,0,0,1
"NT5C2",0,1,0,0,0,0,1
"NTM",0,0,1,0,0,0,1
"NTNG1",0,1,0,0,0,0,1
"NUCKS1",0,1,0,0,0,0,1
"NUP153",0,0,0,0,1,0,1
"NUP88",0,1,0,0,0,0,1
"NWD1",0,1,0,0,0,0,1
"NWD2",0,1,0,0,0,0,1
"NXN",0,1,0,0,0,0,1
"OAS2",0,1,0,0,0,0,1
"OAZ1",0,0,0,0,1,0,1
"OBP2A",0,0,1,0,0,0,1
"OBSCN",0,1,0,0,0,0,1
"ODAM",0,0,0,0,0,1,1
"OGDH",0,0,0,1,0,0,1
"OIT3",0,0,0,1,0,0,1
"OLFML3",0,1,0,0,0,0,1
"OLR1",0,0,1,0,0,0,1
"ONECUT2",0,0,1,0,0,0,1
"OPA3",0,0,1,0,0,0,1
"OR13C4",0,0,0,0,1,0,1
"ORAI3",0,0,0,1,0,0,1
"ORC2",0,0,0,0,1,0,1
"OSBPL1A",0,1,0,0,0,0,1
"OSBPL5",0,0,0,0,1,0,1
"OTUD7B",0,0,0,1,0,0,1
"OTX1",0,1,0,0,0,0,1
"OTX2",0,1,0,0,0,0,1
"OXGR1",0,0,0,1,0,0,1
"P2RY12",0,1,0,0,0,0,1
"PABPC4",0,1,0,0,0,0,1
"PAEP",0,1,0,0,0,0,1
"PALM2-AKAP2",0,1,0,0,0,0,1
"PALMD",0,0,0,1,0,0,1
"PARL",0,0,1,0,0,0,1
"PARP4",0,1,0,0,0,0,1
"PARP6",0,1,0,0,0,0,1
"PARVA",0,1,0,0,0,0,1
"PARVB",0,1,0,0,0,0,1
"PAX3",0,0,0,0,1,0,1
"PBDC1",0,1,0,0,0,0,1
"PCA3",0,0,0,1,0,0,1
"PCBP2",0,0,0,0,0,1,1
"PCCB",0,1,0,0,0,0,1
"PCDH7",0,0,0,1,0,0,1
"PCDH8",0,0,0,0,0,1,1
"PCDHB2",0,0,0,0,1,0,1
"PCDHGC3",0,1,0,0,0,0,1
"PCGF2",0,0,0,0,0,1,1
"PCK2",0,0,0,0,1,0,1
"PCSK1",0,1,0,0,0,0,1
"PDCD7",0,1,0,0,0,0,1
"PDE11A",0,0,0,1,0,0,1
"PDE2A",0,1,0,0,0,0,1
"PDE3B",0,1,0,0,0,0,1
"PDE4D",0,0,1,0,0,0,1
"PDE4DIP",0,0,1,0,0,0,1
"PDE5A",0,0,0,1,0,0,1
"PDE7A",0,0,0,1,0,0,1
"PDIA4",0,0,0,0,0,1,1
"PDIK1L",0,1,0,0,0,0,1
"PDK3",0,1,0,0,0,0,1
"PDLIM2",0,1,0,0,0,0,1
"PDLIM5",0,0,0,1,0,0,1
"PDPR",0,0,1,0,0,0,1
"PDS5A",0,0,1,0,0,0,1
"PDSS2",0,0,0,0,0,1,1
"PDXK",0,0,0,0,0,1,1
"PDYN",0,1,0,0,0,0,1
"PEAK1",0,0,0,0,1,0,1
"PEBP4",0,1,0,0,0,0,1
"PEX1",0,0,0,1,0,0,1
"PEX5",0,1,0,0,0,0,1
"PEX7",0,0,0,1,0,0,1
"PFKFB1",0,1,0,0,0,0,1
"PFKFB2",0,0,0,1,0,0,1
"PGA5",0,0,0,0,0,1,1
"PGAM5",0,0,0,0,0,1,1
"PGLYRP2",0,1,0,0,0,0,1
"PHF12",0,0,0,0,0,1,1
"PHF8",0,0,1,0,0,0,1
"PHKA1",0,0,0,0,0,1,1
"PHLDA2",0,0,0,1,0,0,1
"PHLDA3",0,0,0,0,1,0,1
"PI4KA",0,0,0,1,0,0,1
"PIK3C2A",0,1,0,0,0,0,1
"PIK3C2B",0,1,0,0,0,0,1
"PIK3C2G",1,0,0,0,0,0,1
"PIK3IP1",0,0,0,1,0,0,1
"PIK3R4",0,0,1,0,0,0,1
"PIM3",0,0,0,0,1,0,1
"PINK1",0,1,0,0,0,0,1
"PIP5KL1",0,0,0,0,0,1,1
"PISD",0,1,0,0,0,0,1
"PITPNA",0,1,0,0,0,0,1
"PIWIL3",0,1,0,0,0,0,1
"PKP1",0,0,0,0,0,1,1
"PKP2",0,0,0,0,0,1,1
"PLA2G12A",0,1,0,0,0,0,1
"PLA2G12B",0,1,0,0,0,0,1
"PLA2G2F",0,1,0,0,0,0,1
"PLA2G3",0,1,0,0,0,0,1
"PLA2G5",0,1,0,0,0,0,1
"PLAG1",0,0,0,1,0,0,1
"PLEKHG2",0,0,0,0,1,0,1
"PLEKHG6",0,1,0,0,0,0,1
"PLEKHO1",0,1,0,0,0,0,1
"PLIN3",0,1,0,0,0,0,1
"PLN",0,0,1,0,0,0,1
"PLS1",0,0,0,0,1,0,1
"PLTP",0,0,0,1,0,0,1
"PLVAP",0,0,0,0,1,0,1
"PLXNA4",0,0,0,0,1,0,1
"PMEL",0,1,0,0,0,0,1
"PNLIPRP3",0,0,0,1,0,0,1
"POLD3",0,1,0,0,0,0,1
"POLE2",0,0,0,1,0,0,1
"POLI",0,0,1,0,0,0,1
"POLK",0,1,0,0,0,0,1
"POLR1A",0,0,1,0,0,0,1
"POLR1D",0,1,0,0,0,0,1
"POLR2C",0,1,0,0,0,0,1
"POLR2F",0,1,0,0,0,0,1
"PON2",0,1,0,0,0,0,1
"PON3",0,1,0,0,0,0,1
"POPDC2",0,0,0,0,0,1,1
"POU1F1",0,0,0,0,0,1,1
"POU2AF1",0,1,0,0,0,0,1
"PPID",0,0,0,0,1,0,1
"PPIL1",0,1,0,0,0,0,1
"PPM1B",0,0,0,1,0,0,1
"PPM1G",0,1,0,0,0,0,1
"PPM1H",0,1,0,0,0,0,1
"PPM1K",0,0,0,1,0,0,1
"PPM1L",0,1,0,0,0,0,1
"PPME1",0,0,0,0,0,1,1
"PPP1R12B",0,1,0,0,0,0,1
"PPP1R9B",0,1,0,0,0,0,1
"PPP2CA",0,0,0,1,0,0,1
"PPP2CB",0,1,0,0,0,0,1
"PPP2R2D",0,1,0,0,0,0,1
"PPP2R5E",0,0,0,0,0,1,1
"PPP6R2",0,1,0,0,0,0,1
"PRAME",0,0,1,0,0,0,1
"PRAP1",0,0,0,1,0,0,1
"PRCC",0,1,0,0,0,0,1
"PRDM15",0,0,0,0,1,0,1
"PRDX3",0,0,0,1,0,0,1
"PRDX4",0,0,0,0,0,1,1
"PRG2",0,1,0,0,0,0,1
"PRG3",0,1,0,0,0,0,1
"PRKACA",1,0,0,0,0,0,1
"PRKAR1A",1,0,0,0,0,0,1
"PRKCD",0,1,0,0,0,0,1
"PRKCE",0,0,0,0,0,1,1
"PRKCI",0,1,0,0,0,0,1
"PROK2",0,0,0,1,0,0,1
"PROSP",0,0,0,1,0,0,1
"PRPF4B",0,0,0,1,0,0,1
"PRPS2",0,1,0,0,0,0,1
"PRR11",1,0,0,0,0,0,1
"PRR15",0,1,0,0,0,0,1
"PRR5",0,1,0,0,0,0,1
"PRRG1",0,1,0,0,0,0,1
"PRRX1",0,1,0,0,0,0,1
"PRSS22",0,1,0,0,0,0,1
"PRSS3",0,1,0,0,0,0,1
"PSG9",0,1,0,0,0,0,1
"PSMA3",0,0,0,0,1,0,1
"PSMA4",0,0,0,1,0,0,1
"PSMB1",0,0,0,0,0,1,1
"PSMC2",0,0,0,1,0,0,1
"PSMD11",0,0,0,0,1,0,1
"PSMD12",0,0,0,1,0,0,1
"PSME3",0,1,0,0,0,0,1
"PSPH",0,0,0,0,0,1,1
"PTBP1",0,0,0,1,0,0,1
"PTBP2",0,1,0,0,0,0,1
"PTENP1",0,0,0,0,0,1,1
"PTGDS",0,0,0,1,0,0,1
"PTGFR",0,0,0,0,0,1,1
"PTGR2",0,0,0,0,0,1,1
"PTPRB",0,0,0,0,0,1,1
"PTPRCAP",0,0,0,0,0,1,1
"PTPRD",0,0,0,0,0,1,1
"PTPRM",0,1,0,0,0,0,1
"PTPRS",0,1,0,0,0,0,1
"PTPRT",0,1,0,0,0,0,1
"PTPRU",0,1,0,0,0,0,1
"PUM1",1,0,0,0,0,0,1
"PVRL3",0,0,0,0,0,1,1
"PWP1",0,0,0,0,1,0,1
"PYCARD",0,0,0,1,0,0,1
"PYGO1",0,1,0,0,0,0,1
"PYGO2",0,0,0,1,0,0,1
"PZP",0,0,1,0,0,0,1
"RAB15",0,0,0,1,0,0,1
"RAB18",0,0,0,1,0,0,1
"RAB24",0,0,0,1,0,0,1
"RAB26",0,0,0,0,0,1,1
"RAB27B",0,0,0,1,0,0,1
"RAB31",0,0,0,1,0,0,1
"RAB34",0,0,0,0,0,1,1
"RAB3D",0,0,0,0,0,1,1
"RAB40AL",0,0,0,0,1,0,1
"RAB40C",0,0,0,0,0,1,1
"RAB4B",0,0,0,1,0,0,1
"RABAC1",0,1,0,0,0,0,1
"RABEP2",0,1,0,0,0,0,1
"RABGAP1",0,1,0,0,0,0,1
"RAD18",0,1,0,0,0,0,1
"RAD51B",0,1,0,0,0,0,1
"RAD52",0,1,0,0,0,0,1
"RAET1E",0,1,0,0,0,0,1
"RAET1G",0,1,0,0,0,0,1
"RALY",0,1,0,0,0,0,1
"RANBP1",0,1,0,0,0,0,1
"RANBP2",0,1,0,0,0,0,1
"RAPGEF2",0,1,0,0,0,0,1
"RAPGEF5",0,0,0,1,0,0,1
"RASA3",0,1,0,0,0,0,1
"RASD1",0,0,0,1,0,0,1
"RASGEF1A",1,0,0,0,0,0,1
"RASGRF1",0,0,0,0,0,1,1
"RASGRP2",0,1,0,0,0,0,1
"RASGRP3",0,0,0,1,0,0,1
"RASSF6",0,0,0,0,0,1,1
"RASSF7",0,0,0,0,0,1,1
"RASSF9",0,0,0,1,0,0,1
"RBAK",1,0,0,0,0,0,1
"RBBP9",0,0,0,0,1,0,1
"RBM4",0,0,1,0,0,0,1
"RBM5",0,0,0,0,1,0,1
"RBMS3",0,0,1,0,0,0,1
"RBMXL1",0,0,0,0,0,1,1
"RBP4",0,0,0,0,0,1,1
"RCAN1",0,0,0,0,1,0,1
"RCC2",0,0,0,0,0,1,1
"RCOR3",0,0,0,1,0,0,1
"RD3",0,1,0,0,0,0,1
"RDH10",0,0,0,1,0,0,1
"REEP2",0,0,0,0,0,1,1
"RELT",0,1,0,0,0,0,1
"REN",0,0,0,0,1,0,1
"RERE",0,1,0,0,0,0,1
"RETNLB",0,1,0,0,0,0,1
"REV3L",0,0,1,0,0,0,1
"RFC3",0,1,0,0,0,0,1
"RFFL",0,1,0,0,0,0,1
"RGL1",0,0,0,0,1,0,1
"RGL2",0,0,0,0,1,0,1
"RGS10",0,1,0,0,0,0,1
"RGS14",0,1,0,0,0,0,1
"RGS17",0,0,0,1,0,0,1
"RGS22",0,0,1,0,0,0,1
"RGS7",0,1,0,0,0,0,1
"RHBDD2",0,1,0,0,0,0,1
"RHCG",0,0,1,0,0,0,1
"RHOBTB1",0,1,0,0,0,0,1
"RHOBTB2",0,0,0,0,0,1,1
"RHOD",0,0,0,0,0,1,1
"RHOQ",0,1,0,0,0,0,1
"RHOXF1",0,1,0,0,0,0,1
"RIF1",0,1,0,0,0,0,1
"RIPK2",0,1,0,0,0,0,1
"RIPK4",0,0,0,0,1,0,1
"RMI1",0,1,0,0,0,0,1
"RNF13",0,0,0,0,1,0,1
"RNF138",0,1,0,0,0,0,1
"RNF180",0,0,0,0,0,1,1
"RNF20",0,1,0,0,0,0,1
"RNF216",0,1,0,0,0,0,1
"RNF40",0,1,0,0,0,0,1
"RNMTL1",0,0,0,1,0,0,1
"RPGRIP1L",0,0,0,1,0,0,1
"RPL10",0,0,0,1,0,0,1
"RPL10A",0,1,0,0,0,0,1
"RPL11",0,0,0,0,0,1,1
"RPL13",0,0,0,0,1,0,1
"RPL13A",0,0,0,1,0,0,1
"RPL21",0,1,0,0,0,0,1
"RPL3",0,1,0,0,0,0,1
"RPL32",0,1,0,0,0,0,1
"RPL34",0,0,0,0,0,1,1
"RPL36",0,0,0,1,0,0,1
"RPL39L",0,0,0,1,0,0,1
"RPL4",0,0,0,1,0,0,1
"RPL41",1,0,0,0,0,0,1
"RPL7A",0,1,0,0,0,0,1
"RPLP1",0,1,0,0,0,0,1
"RPS11",0,1,0,0,0,0,1
"RPS21",0,0,0,1,0,0,1
"RPS23",0,1,0,0,0,0,1
"RPS27L",0,1,0,0,0,0,1
"RPS3A",0,0,0,1,0,0,1
"RPS4X",0,1,0,0,0,0,1
"RPS6KA4",0,1,0,0,0,0,1
"RPS6KL1",0,1,0,0,0,0,1
"RPUSD2",0,1,0,0,0,0,1
"RRAS",0,1,0,0,0,0,1
"RRBP1",0,1,0,0,0,0,1
"RSF1",0,0,1,0,0,0,1
"RSPO3",0,1,0,0,0,0,1
"RSRC2",0,0,1,0,0,0,1
"RTF1",0,1,0,0,0,0,1
"RWDD1",0,1,0,0,0,0,1
"RXFP4",0,1,0,0,0,0,1
"S100A5",0,1,0,0,0,0,1
"SAA2",0,1,0,0,0,0,1
"SAC3D1",0,1,0,0,0,0,1
"SACS",0,1,0,0,0,0,1
"SAE1",0,0,0,0,0,1,1
"SALL2",0,0,1,0,0,0,1
"SAMD14",0,1,0,0,0,0,1
"SAMD9L",0,1,0,0,0,0,1
"SAMHD1",0,0,0,1,0,0,1
"SAMSN1",0,1,0,0,0,0,1
"SBDS",0,0,0,0,1,0,1
"SBNO2",0,0,0,0,1,0,1
"SCAMP3",0,0,0,1,0,0,1
"SCARB2",0,0,0,1,0,0,1
"SCGB1A1",0,1,0,0,0,0,1
"SCGB3A1",0,0,0,1,0,0,1
"SCIN",0,1,0,0,0,0,1
"SCN4A",0,1,0,0,0,0,1
"SCRIB",0,0,0,1,0,0,1
"SCRT1",0,0,1,0,0,0,1
"SDCBP2",0,1,0,0,0,0,1
"SDCCAG3",0,1,0,0,0,0,1
"SDPR",0,0,0,0,0,1,1
"SEC16B",0,1,0,0,0,0,1
"SEC23B",0,0,0,1,0,0,1
"SEC62",0,0,0,1,0,0,1
"SEMA3E",0,1,0,0,0,0,1
"SEMA4F",0,1,0,0,0,0,1
"SEMA4G",0,1,0,0,0,0,1
"SEMA6B",0,1,0,0,0,0,1
"SEMA6C",0,1,0,0,0,0,1
"SEMA6D",0,1,0,0,0,0,1
"SEMG1",0,1,0,0,0,0,1
"SEMG2",0,0,1,0,0,0,1
"SENP1",0,1,0,0,0,0,1
"SENP2",0,0,0,1,0,0,1
"SENP3",0,0,0,0,1,0,1
"SENP6",0,0,0,1,0,0,1
"SEPN1",0,1,0,0,0,0,1
"SEPW1",0,1,0,0,0,0,1
"SERBP1",0,0,1,0,0,0,1
"SERPINA6",0,0,0,1,0,0,1
"SERPINB1",0,0,0,1,0,0,1
"SERPINB4",0,0,0,1,0,0,1
"SESN1",0,0,0,0,1,0,1
"SESN2",0,1,0,0,0,0,1
"SETD1B",0,1,0,0,0,0,1
"SETDB2",0,1,0,0,0,0,1
"SF3B3",0,0,0,1,0,0,1
"SF3B4",0,0,0,1,0,0,1
"SGCZ",1,0,0,0,0,0,1
"SGF29",0,0,0,1,0,0,1
"SGSM3",0,0,0,1,0,0,1
"SGTB",0,0,0,1,0,0,1
"SH2D4A",0,0,0,1,0,0,1
"SH3BP4",0,1,0,0,0,0,1
"SH3GL1",0,1,0,0,0,0,1
"SH3GL3",0,1,0,0,0,0,1
"SH3RF1",0,1,0,0,0,0,1
"SH3RF2",0,1,0,0,0,0,1
"SHANK1",0,0,0,1,0,0,1
"SHANK2",0,0,1,0,0,0,1
"SHARPIN",0,0,0,1,0,0,1
"SHF",0,0,0,0,0,1,1
"SHROOM2",0,1,0,0,0,0,1
"SIAH2",0,0,0,0,1,0,1
"SIGLEC1",0,1,0,0,0,0,1
"SIGLEC7",0,1,0,0,0,0,1
"SIM1",0,0,0,0,1,0,1
"SIN3B",0,0,0,0,1,0,1
"SIPA1",0,1,0,0,0,0,1
"SIRT4",0,0,0,1,0,0,1
"SKA1",0,0,0,1,0,0,1
"SKAP2",0,0,1,0,0,0,1
"SKIL",0,0,1,0,0,0,1
"SLC11A1",0,0,1,0,0,0,1
"SLC12A2",0,1,0,0,0,0,1
"SLC15A2",0,0,0,1,0,0,1
"SLC16A7",0,1,0,0,0,0,1
"SLC17A9",0,1,0,0,0,0,1
"SLC22A11",0,0,0,0,1,0,1
"SLC22A18",0,0,0,0,1,0,1
"SLC22A6",0,0,0,1,0,0,1
"SLC22A8",0,0,0,1,0,0,1
"SLC25A23",0,1,0,0,0,0,1
"SLC25A5",0,1,0,0,0,0,1
"SLC27A3",0,0,0,1,0,0,1
"SLC27A5",0,0,1,0,0,0,1
"SLC28A3",0,0,0,0,1,0,1
"SLC29A3",0,0,0,0,1,0,1
"SLC2A10",0,1,0,0,0,0,1
"SLC2A8",0,1,0,0,0,0,1
"SLC2A9",0,1,0,0,0,0,1
"SLC30A10",0,1,0,0,0,0,1
"SLC32A1",0,0,0,0,1,0,1
"SLC35F5",0,1,0,0,0,0,1
"SLC36A1",0,1,0,0,0,0,1
"SLC38A4",0,0,0,1,0,0,1
"SLC39A10",0,1,0,0,0,0,1
"SLC39A3",0,0,0,0,1,0,1
"SLC39A8",0,1,0,0,0,0,1
"SLC40A1",0,0,0,1,0,0,1
"SLC44A4",0,0,0,0,1,0,1
"SLC45A3",0,1,0,0,0,0,1
"SLC4A2",0,0,0,0,0,1,1
"SLC4A4",0,1,0,0,0,0,1
"SLC4A7",0,1,0,0,0,0,1
"SLC5A9",0,1,0,0,0,0,1
"SLC6A14",0,1,0,0,0,0,1
"SLC6A6",0,1,0,0,0,0,1
"SLC7A11",0,0,0,0,0,1,1
"SLC7A2",0,0,0,1,0,0,1
"SLC9A9",0,1,0,0,0,0,1
"SLPI",0,0,0,0,0,1,1
"SMAD6",0,0,0,1,0,0,1
"SMAD9",0,1,0,0,0,0,1
"SMARCAD1",0,0,0,1,0,0,1
"SMARCD2",0,0,0,1,0,0,1
"SMC4",0,0,0,0,1,0,1
"SMG1",0,0,0,1,0,0,1
"SMPD3",0,1,0,0,0,0,1
"SMYD2",0,0,0,1,0,0,1
"SNED1",0,1,0,0,0,0,1
"SNHG1",0,0,0,0,0,1,1
"SNN",0,0,1,0,0,0,1
"SNORD123",0,1,0,0,0,0,1
"SNRK",0,1,0,0,0,0,1
"SNRPD3",0,1,0,0,0,0,1
"SNRPE",0,0,0,1,0,0,1
"SNTA1",0,1,0,0,0,0,1
"SNX10",0,0,1,0,0,0,1
"SOBP",1,0,0,0,0,0,1
"SOCS7",0,0,0,1,0,0,1
"SORCS3",0,0,0,0,0,1,1
"SOX11",0,0,0,1,0,0,1
"SOX13",0,1,0,0,0,0,1
"SOX15",0,0,0,0,1,0,1
"SOX21",0,1,0,0,0,0,1
"SOX8",0,0,0,1,0,0,1
"SP100",0,0,0,1,0,0,1
"SP140",0,0,0,1,0,0,1
"SP2",0,0,0,0,0,1,1
"SPAG1",0,0,0,0,1,0,1
"SPATA20",1,0,0,0,0,0,1
"SPIB",0,1,0,0,0,0,1
"SPIC",0,1,0,0,0,0,1
"SPINK4",0,1,0,0,0,0,1
"SPOCK2",0,1,0,0,0,0,1
"SPRR1A",0,0,0,0,0,1,1
"SPRR1B",0,0,0,0,0,1,1
"SQLE",0,1,0,0,0,0,1
"SRD5A1",0,0,0,1,0,0,1
"SRGAP1",0,0,0,0,1,0,1
"SRL",0,0,0,0,1,0,1
"SRMS",0,1,0,0,0,0,1
"SRP72",0,0,0,1,0,0,1
"SRRM1",0,0,0,1,0,0,1
"SSBP1",0,0,0,0,0,1,1
"SSBP2",1,0,0,0,0,0,1
"SSX1",0,1,0,0,0,0,1
"SSX4",0,1,0,0,0,0,1
"ST3GAL5",0,0,0,1,0,0,1
"ST8SIA1",0,1,0,0,0,0,1
"STAR",0,0,0,0,0,1,1
"STARD8",0,0,0,1,0,0,1
"STAU2",0,0,0,1,0,0,1
"STEAP1",0,1,0,0,0,0,1
"STEAP2",0,1,0,0,0,0,1
"STIP1",0,1,0,0,0,0,1
"STK35",0,1,0,0,0,0,1
"STOML1",0,0,0,0,0,1,1
"STRA6",0,1,0,0,0,0,1
"STX17",0,0,0,1,0,0,1
"STX2",0,0,0,0,1,0,1
"SULT1A2",0,1,0,0,0,0,1
"SULT1A3",0,1,0,0,0,0,1
"SUMO2",0,1,0,0,0,0,1
"SUV39H2",0,0,0,0,0,1,1
"SYAP1",0,0,0,1,0,0,1
"SYN1",0,1,0,0,0,0,1
"SYNCRIP",0,1,0,0,0,0,1
"SYNE1",0,0,0,0,1,0,1
"SYNE2",1,0,0,0,0,0,1
"SYNGAP1",0,0,0,1,0,0,1
"SYNPO2",0,1,0,0,0,0,1
"TAB1",0,1,0,0,0,0,1
"TACR2",0,1,0,0,0,0,1
"TAF4B",0,1,0,0,0,0,1
"TALDO1",0,0,0,1,0,0,1
"TAOK1",0,0,0,0,0,1,1
"TAS1R3",1,0,0,0,0,0,1
"TBC1D1",0,0,0,0,0,1,1
"TBCA",0,0,0,0,0,1,1
"TBX18",0,1,0,0,0,0,1
"TBX19",0,1,0,0,0,0,1
"TCAP",0,0,0,0,0,1,1
"TCEA2",0,0,0,1,0,0,1
"TCEAL6",0,1,0,0,0,0,1
"TCEAL7",0,0,0,0,0,1,1
"TCERG1",0,1,0,0,0,0,1
"TCF7L1",0,1,0,0,0,0,1
"TCN2",0,1,0,0,0,0,1
"TCP10L",0,0,0,1,0,0,1
"TDO2",0,0,0,0,1,0,1
"TEAD2",0,0,0,0,1,0,1
"TEKT5",0,1,0,0,0,0,1
"TESPA1",0,1,0,0,0,0,1
"TFAP2A",0,1,0,0,0,0,1
"TFAP2B",0,1,0,0,0,0,1
"TFAP2C",0,0,0,0,0,1,1
"TGFBR3",0,1,0,0,0,0,1
"THADA",0,1,0,0,0,0,1
"THBS4",0,1,0,0,0,0,1
"THOC1",0,0,0,0,1,0,1
"THPO",0,0,0,0,0,1,1
"THSD4",0,0,1,0,0,0,1
"TIA1",0,1,0,0,0,0,1
"TIAM2",0,0,0,1,0,0,1
"TIGIT",0,0,1,0,0,0,1
"TIMELESS",0,1,0,0,0,0,1
"TIMP4",0,1,0,0,0,0,1
"TIPARP",0,1,0,0,0,0,1
"TKTL2",0,0,0,1,0,0,1
"TLE2",0,0,1,0,0,0,1
"TLE6",0,1,0,0,0,0,1
"TLK1",1,0,0,0,0,0,1
"TLL1",0,0,0,0,1,0,1
"TLN2",0,0,0,0,0,1,1
"TLX2",0,0,0,0,1,0,1
"TLX3",0,0,1,0,0,0,1
"TMC5",1,0,0,0,0,0,1
"TMEM147",0,1,0,0,0,0,1
"TMEM176A",0,0,0,1,0,0,1
"TMEM176B",0,0,0,1,0,0,1
"TMEM18",0,1,0,0,0,0,1
"TMEM192",0,0,0,1,0,0,1
"TMEM207",0,0,0,0,0,1,1
"TMEM30A",0,0,0,0,1,0,1
"TMEM45A",0,0,0,1,0,0,1
"TMEM69",0,1,0,0,0,0,1
"TMEM9",0,0,0,1,0,0,1
"TMEM97",0,1,0,0,0,0,1
"TMPRSS6",0,0,0,1,0,0,1
"TMSB10",0,0,0,0,1,0,1
"TMSB15A",0,1,0,0,0,0,1
"TMSB15B",0,1,0,0,0,0,1
"TNFAIP8",0,0,0,0,1,0,1
"TNFAIP8L2",0,0,0,1,0,0,1
"TNFSF11",0,1,0,0,0,0,1
"TNNC1",0,1,0,0,0,0,1
"TNP2",0,1,0,0,0,0,1
"TNRC6B",0,0,0,1,0,0,1
"TNS2",0,0,0,1,0,0,1
"TOPORS",0,1,0,0,0,0,1
"TP53AIP1",0,0,0,0,1,0,1
"TP53TG1",0,1,0,0,0,0,1
"TP73-AS1",0,0,1,0,0,0,1
"TPM2",0,1,0,0,0,0,1
"TPTE2",1,0,0,0,0,0,1
"TPTE2P1",1,0,0,0,0,0,1
"TRAPPC4",0,0,0,0,0,1,1
"TREM2",0,0,1,0,0,0,1
"TREX2",0,1,0,0,0,0,1
"TRGV2",0,1,0,0,0,0,1
"TRIB1",0,0,1,0,0,0,1
"TRIB3",0,0,0,0,1,0,1
"TRIM35",0,0,0,1,0,0,1
"TRIM41",0,1,0,0,0,0,1
"TRIM44",0,0,0,0,0,1,1
"TRIM5",0,0,0,0,1,0,1
"TRIO",0,1,0,0,0,0,1
"TRIP4",0,1,0,0,0,0,1
"TRIP6",0,1,0,0,0,0,1
"TRPC4",0,0,0,0,1,0,1
"TRPC5",0,0,0,0,1,0,1
"TRPV2",0,0,0,1,0,0,1
"TRPV3",0,0,0,0,1,0,1
"TRPV4",0,0,0,0,1,0,1
"TSC22D1",0,0,0,1,0,0,1
"TSHB",0,0,0,1,0,0,1
"TSPAN6",0,1,0,0,0,0,1
"TSPO2",0,0,0,1,0,0,1
"TSPYL2",0,0,0,1,0,0,1
"TSPYL5",0,0,0,0,0,1,1
"TST",0,0,0,1,0,0,1
"TTC28",0,1,0,0,0,0,1
"TTL",0,0,0,0,1,0,1
"TTLL4",0,0,0,0,1,0,1
"TTYH2",0,1,0,0,0,0,1
"TUBA1B",0,0,0,1,0,0,1
"TUBA8",0,0,0,1,0,0,1
"TUFM",0,1,0,0,0,0,1
"TUG1",0,0,0,1,0,0,1
"TXK",0,0,0,1,0,0,1
"TXNDC9",0,1,0,0,0,0,1
"TXNRD3",0,1,0,0,0,0,1
"TYRP1",0,1,0,0,0,0,1
"U2AF2",0,1,0,0,0,0,1
"UBA2",0,0,0,1,0,0,1
"UBAP1",0,1,0,0,0,0,1
"UBB",0,0,0,1,0,0,1
"UBE2K",0,0,0,0,1,0,1
"UBE2L6",0,0,1,0,0,0,1
"UBE2N",0,1,0,0,0,0,1
"UBE2Q1",0,1,0,0,0,0,1
"UBE2Q2",0,1,0,0,0,0,1
"UBE2S",0,0,1,0,0,0,1
"UBE3C",0,0,0,1,0,0,1
"UBE4B",0,0,0,1,0,0,1
"UBIAD1",0,0,0,1,0,0,1
"UBL3",0,0,1,0,0,0,1
"UBR2",0,0,0,0,1,0,1
"UBXN2A",0,1,0,0,0,0,1
"UCK1",0,0,0,0,0,1,1
"UCK2",0,0,0,0,0,1,1
"UGT1A5",0,1,0,0,0,0,1
"UGT2B10",0,0,0,1,0,0,1
"UPF2",0,1,0,0,0,0,1
"UPF3B",1,0,0,0,0,0,1
"UROD",0,0,0,1,0,0,1
"USP18",0,0,0,1,0,0,1
"USP2",0,0,0,1,0,0,1
"USP28",0,1,0,0,0,0,1
"USP4",0,0,1,0,0,0,1
"USP6",0,0,0,0,0,1,1
"UTP23",0,1,0,0,0,0,1
"UTRN",0,0,0,0,1,0,1
"UXT",0,0,0,0,0,1,1
"VASN",0,0,0,1,0,0,1
"VAV1",0,0,0,0,1,0,1
"VBP1",0,0,0,1,0,0,1
"VEZT",0,0,0,0,0,1,1
"VGLL4",0,0,0,0,1,0,1
"VKORC1",0,0,0,1,0,0,1
"VNN3",0,0,0,1,0,0,1
"VPS37A",0,0,0,1,0,0,1
"VPS52",0,1,0,0,0,0,1
"VSNL1",0,0,0,0,0,1,1
"VSX2",0,0,0,1,0,0,1
"VWA5A",0,1,0,0,0,0,1
"WBP5",0,1,0,0,0,0,1
"WDR62",0,0,0,0,0,1,1
"WDR66",0,1,0,0,0,0,1
"WDR72",0,0,1,0,0,0,1
"WDR77",0,1,0,0,0,0,1
"WDR83",0,0,0,0,0,1,1
"WFS1",0,0,0,1,0,0,1
"WIPF1",0,1,0,0,0,0,1
"WLS",0,1,0,0,0,0,1
"WNK4",0,1,0,0,0,0,1
"WRAP53",0,0,0,1,0,0,1
"WSB1",0,0,0,0,1,0,1
"WTAP",1,0,0,0,0,0,1
"XPO6",0,1,0,0,0,0,1
"XRN2",0,0,0,1,0,0,1
"XRRA1",0,1,0,0,0,0,1
"YOD1",0,0,0,1,0,0,1
"YPEL3",0,1,0,0,0,0,1
"ZAP70",0,1,0,0,0,0,1
"ZAR1",0,0,0,1,0,0,1
"ZBTB32",0,0,1,0,0,0,1
"ZBTB34",0,0,0,0,1,0,1
"ZCCHC11",0,0,0,1,0,0,1
"ZDHHC1",0,1,0,0,0,0,1
"ZDHHC14",0,0,0,0,0,1,1
"ZDHHC2",0,0,0,0,0,1,1
"ZDHHC9",0,1,0,0,0,0,1
"ZEB1-AS1",0,0,0,1,0,0,1
"ZEB2-AS1",0,0,0,1,0,0,1
"ZFAS1",0,0,0,1,0,0,1
"ZFP36",0,1,0,0,0,0,1
"ZFP36L1",0,1,0,0,0,0,1
"ZFP64",0,0,0,0,0,1,1
"ZFP90",0,1,0,0,0,0,1
"ZFYVE26",1,0,0,0,0,0,1
"ZG16",0,0,0,1,0,0,1
"ZHX1",0,0,0,1,0,0,1
"ZHX3",0,0,0,1,0,0,1
"ZMPSTE24",0,0,0,1,0,0,1
"ZNF131",0,1,0,0,0,0,1
"ZNF132",0,1,0,0,0,0,1
"ZNF133",0,1,0,0,0,0,1
"ZNF138",0,1,0,0,0,0,1
"ZNF177",0,0,0,0,0,1,1
"ZNF185",0,0,0,1,0,0,1
"ZNF202",0,1,0,0,0,0,1
"ZNF281",0,1,0,0,0,0,1
"ZNF346",0,1,0,0,0,0,1
"ZNF365",0,0,0,0,0,1,1
"ZNF382",0,0,1,0,0,0,1
"ZNF462",0,0,0,0,1,0,1
"ZNF484",0,0,0,1,0,0,1
"ZNF559",0,0,0,0,0,1,1
"ZNF610",0,0,0,0,0,1,1
"ZNF664",0,0,0,0,0,1,1
"ZNF689",0,0,0,1,0,0,1
"ZNF706",0,0,0,0,0,1,1
"ZRANB3",0,0,1,0,0,0,1
